geography,geography code,Total_Migrant,Migration: Lived at same address one year ago; measures: Value,Migration: Migrants: Total; measures: Value,Migration: Migrants: Moved within the area; measures: Value,Migration: Migrants: Moved into the area from within the UK; measures: Value,Migration: Migrants: Moved into the area from outside the UK; measures: Value,Migration: Moved out of the area; measures: Value
Darlington 001,E02002559,8842,7967,875,150,650,75,739
Darlington 002,E02002560,5997,5530,467,67,376,24,373
Darlington 003,E02002561,5741,5371,370,67,287,16,412
Darlington 004,E02002562,6066,5367,699,126,547,26,614
Darlington 005,E02002563,5463,5067,396,49,332,15,333
Darlington 006,E02002564,9502,8746,756,193,543,20,605
Darlington 007,E02002565,5450,4713,737,93,613,31,649
Darlington 008,E02002566,6918,5478,1440,225,1141,74,1056
Darlington 009,E02002567,7254,6502,752,130,591,31,571
Darlington 010,E02002568,5905,5210,695,77,566,52,508
Darlington 011,E02002569,9095,8479,616,97,488,31,497
Darlington 012,E02002570,8213,7172,1041,204,765,72,812
Darlington 013,E02002571,6516,5911,605,94,478,33,482
Darlington 014,E02002572,6312,5500,812,132,629,51,686
Darlington 015,E02002573,8290,7376,914,217,662,35,514
County Durham 002,E02004290,5981,5587,394,89,281,24,346
County Durham 005,E02004291,6787,6255,532,139,385,8,406
County Durham 007,E02004292,7916,7261,655,116,513,26,470
County Durham 011,E02004293,9379,8531,848,199,617,32,598
County Durham 013,E02004294,8484,7810,674,102,541,31,526
County Durham 015,E02004295,7537,6976,561,120,411,30,369
County Durham 019,E02004296,8033,7387,646,163,467,16,454
County Durham 001,E02004297,7900,7305,595,158,416,21,447
County Durham 003,E02004298,9703,8989,714,119,563,32,687
County Durham 004,E02004299,8474,7659,815,175,615,25,576
County Durham 006,E02004300,7686,6990,696,224,454,18,472
County Durham 008,E02004301,8894,7966,928,309,612,7,503
County Durham 009,E02004302,7747,6832,915,214,694,7,658
County Durham 010,E02004303,11457,10256,1201,316,843,42,906
County Durham 012,E02004304,8892,7933,959,219,713,27,601
County Durham 014,E02004305,8640,7718,922,199,686,37,620
County Durham 020,E02004306,5789,5362,427,91,323,13,415
County Durham 024,E02004307,6570,6062,508,137,353,18,368
County Durham 022,E02004308,7819,7031,788,82,664,42,611
County Durham 023,E02004309,5902,5266,636,97,473,66,469
County Durham 026,E02004310,7962,7202,760,174,561,25,495
County Durham 027,E02004311,9108,8343,765,199,531,35,574
County Durham 028,E02004312,7549,6973,576,129,410,37,493
County Durham 029,E02004313,6684,5201,1483,263,1089,131,982
County Durham 030,E02004314,12248,3799,8449,2430,5040,979,3838
County Durham 033,E02004315,10184,7607,2577,347,1982,248,1823
County Durham 031,E02004316,5683,5168,515,159,350,6,467
County Durham 038,E02004317,7663,6994,669,181,465,23,389
County Durham 041,E02004318,6099,5354,745,114,579,52,505
County Durham 044,E02004319,7474,6861,613,205,387,21,421
County Durham 016,E02004320,8956,8264,692,194,473,25,519
County Durham 017,E02004321,8345,7468,877,251,573,53,584
County Durham 018,E02004322,8490,7796,694,172,506,16,539
County Durham 021,E02004323,7906,6941,965,181,752,32,456
County Durham 025,E02004324,5732,5138,594,175,403,16,413
County Durham 032,E02004325,8722,7941,781,219,552,10,657
County Durham 034,E02004326,6190,5672,518,209,294,15,346
County Durham 036,E02004327,6374,5745,629,230,382,17,420
County Durham 035,E02004328,7337,6810,527,118,398,11,433
County Durham 037,E02004329,6772,6334,438,96,322,20,399
County Durham 039,E02004330,5944,5457,487,159,314,14,328
County Durham 040,E02004331,7085,6317,768,290,459,19,354
County Durham 043,E02004332,7278,6743,535,155,367,13,414
County Durham 047,E02004333,7181,6721,460,95,351,14,428
County Durham 048,E02004334,7370,6850,520,233,265,22,346
County Durham 049,E02004335,6289,5561,728,171,552,5,550
County Durham 050,E02004336,6876,6238,638,230,387,21,392
County Durham 052,E02004337,9106,8187,919,200,690,29,512
County Durham 053,E02004338,6761,6127,634,244,383,7,399
County Durham 054,E02004339,6879,6382,497,148,304,45,378
County Durham 059,E02004340,10363,9287,1076,568,489,19,511
County Durham 060,E02004341,8417,7806,611,107,469,35,593
County Durham 061,E02004342,5967,5246,721,180,520,21,529
County Durham 062,E02004343,5527,5063,464,102,350,12,369
County Durham 063,E02004344,7034,6495,539,101,416,22,467
County Durham 064,E02004345,12759,11747,1012,353,613,46,658
County Durham 065,E02004346,5241,4808,433,95,311,27,348
County Durham 066,E02004347,7040,6108,932,260,619,53,468
County Durham 042,E02004348,8063,7425,638,219,394,25,393
County Durham 045,E02004349,9228,8414,814,321,485,8,562
County Durham 046,E02004350,9614,8756,858,211,619,28,639
County Durham 051,E02004351,7025,6322,703,227,464,12,473
County Durham 055,E02004352,7566,6557,1009,205,770,34,645
County Durham 056,E02004353,7549,6973,576,154,397,25,574
County Durham 057,E02004354,8755,7879,876,238,608,30,567
County Durham 058,E02004355,7257,6322,935,296,616,23,487
Hartlepool 001,E02002483,9084,8277,807,151,631,25,525
Hartlepool 002,E02002484,10316,9233,1083,345,707,31,718
Hartlepool 003,E02002485,7835,7032,803,186,604,13,675
Hartlepool 005,E02002487,5357,4290,1067,190,835,42,717
Hartlepool 006,E02002488,6110,5644,466,34,404,28,495
Hartlepool 007,E02002489,7927,6655,1272,277,965,30,832
Hartlepool 008,E02002490,6079,5362,717,185,509,23,633
Hartlepool 009,E02002491,6559,5956,603,111,484,8,389
Hartlepool 010,E02002492,6684,6187,497,78,414,5,525
Hartlepool 011,E02002493,6458,6004,454,86,354,14,283
Hartlepool 012,E02002494,7750,7124,626,167,453,6,556
Hartlepool 014,E02006909,11869,11191,678,116,531,31,695
Middlesbrough 001,E02002496,11646,8044,3602,942,2117,543,2087
Middlesbrough 002,E02002497,6268,5373,895,185,682,28,700
Middlesbrough 003,E02002498,8584,6030,2554,529,1672,353,1579
Middlesbrough 004,E02002499,7516,6830,686,158,519,9,573
Middlesbrough 005,E02002500,5919,5046,873,103,727,43,508
Middlesbrough 006,E02002501,5346,4745,601,86,496,19,569
Middlesbrough 007,E02002502,9615,8801,814,232,569,13,516
Middlesbrough 008,E02002503,6515,5890,625,101,503,21,400
Middlesbrough 009,E02002504,9711,8596,1115,139,873,103,791
Middlesbrough 010,E02002505,6254,5815,439,94,338,7,399
Middlesbrough 011,E02002506,5932,5169,763,118,608,37,535
Middlesbrough 012,E02002507,6027,5536,491,38,417,36,406
Middlesbrough 013,E02002508,5074,4773,301,28,256,17,309
Middlesbrough 014,E02002509,5583,5119,464,87,358,19,318
Middlesbrough 015,E02002510,5712,5387,325,47,259,19,296
Middlesbrough 017,E02002512,5305,4954,351,43,281,27,316
Middlesbrough 018,E02002513,8844,8158,686,166,490,30,586
Middlesbrough 019,E02002514,8967,8394,573,80,467,26,601
Middlesbrough 020,E02006811,9594,8912,682,135,519,28,489
Northumberland 004,E02005702,6554,5748,806,188,580,38,596
Northumberland 005,E02005703,6766,6079,687,239,427,21,398
Northumberland 006,E02005704,12408,11449,959,365,561,33,677
Northumberland 007,E02005705,7509,6808,701,210,457,34,471
Northumberland 001,E02005706,9620,8534,1086,511,524,51,462
Northumberland 002,E02005707,6897,6190,707,178,507,22,429
Northumberland 003,E02005708,10450,9366,1084,373,684,27,554
Northumberland 022,E02005709,6860,6067,793,230,552,11,519
Northumberland 023,E02005710,8431,7331,1100,291,785,24,686
Northumberland 024,E02005711,8341,7652,689,170,506,13,534
Northumberland 025,E02005712,7030,6365,665,124,525,16,508
Northumberland 026,E02005713,6677,6325,352,79,259,14,376
Northumberland 027,E02005714,5380,5139,241,59,168,14,288
Northumberland 029,E02005715,8633,7811,822,184,625,13,598
Northumberland 028,E02005716,8783,8064,719,135,565,19,549
Northumberland 030,E02005717,7805,7264,541,129,393,19,479
Northumberland 031,E02005718,6617,6091,526,82,422,22,438
Northumberland 032,E02005719,7617,6867,750,186,546,18,490
Northumberland 008,E02005720,12092,10558,1534,346,1136,52,864
Northumberland 011,E02005721,5180,4639,541,121,401,19,320
Northumberland 015,E02005722,7115,6525,590,114,445,31,542
Northumberland 016,E02005723,6281,5631,650,152,469,29,448
Northumberland 018,E02005724,6146,5735,411,45,335,31,313
Northumberland 033,E02005725,6516,5923,593,142,430,21,368
Northumberland 034,E02005726,7708,7125,583,87,466,30,621
Northumberland 019,E02005727,6398,5830,568,176,364,28,439
Northumberland 037,E02005728,7102,6534,568,227,316,25,383
Northumberland 036,E02005729,5620,5113,507,93,381,33,417
Northumberland 035,E02005730,13097,11656,1441,563,793,85,767
Northumberland 038,E02005731,10853,10065,788,334,432,22,473
Northumberland 039,E02005732,9052,8294,758,162,559,37,629
Northumberland 040,E02005733,8136,7442,694,165,502,27,554
Northumberland 009,E02005734,6308,5740,568,217,332,19,342
Northumberland 010,E02005735,7940,6899,1041,327,690,24,624
Northumberland 013,E02005736,7555,6717,838,164,656,18,647
Northumberland 012,E02005737,7227,6636,591,101,476,14,520
Northumberland 014,E02005738,5067,4753,314,32,268,14,394
Northumberland 017,E02005739,9464,8653,811,208,574,29,537
Northumberland 020,E02005740,10275,9066,1209,400,788,21,582
Northumberland 021,E02005741,8518,7836,682,194,449,39,479
Redcar and Cleveland 001,E02002515,6810,5702,1108,281,801,26,789
Redcar and Cleveland 002,E02002516,5734,5348,386,67,311,8,494
Redcar and Cleveland 003,E02002517,5380,5018,362,62,295,5,369
Redcar and Cleveland 004,E02002518,10723,9923,800,209,555,36,674
Redcar and Cleveland 005,E02002519,7045,6277,768,95,664,9,526
Redcar and Cleveland 006,E02002520,13176,12270,906,286,577,43,668
Redcar and Cleveland 007,E02002521,5958,5220,738,236,464,38,351
Redcar and Cleveland 009,E02002523,6514,5678,836,280,550,6,563
Redcar and Cleveland 010,E02002524,5394,4966,428,142,276,10,351
Redcar and Cleveland 011,E02002525,8357,7664,693,145,531,17,516
Redcar and Cleveland 012,E02002526,7454,6811,643,201,425,17,471
Redcar and Cleveland 013,E02002527,5177,4668,509,248,254,7,367
Redcar and Cleveland 015,E02002529,5736,5326,410,63,341,6,417
Redcar and Cleveland 016,E02002530,6519,5978,541,113,420,8,386
Redcar and Cleveland 018,E02002532,6261,5587,674,214,446,14,429
Redcar and Cleveland 019,E02002533,5758,5370,388,88,281,19,365
Redcar and Cleveland 020,E02002534,5758,5394,364,44,297,23,282
Redcar and Cleveland 021,E02006812,7353,6855,498,107,380,11,475
Redcar and Cleveland 022,E02006910,10070,9391,679,194,470,15,618
Stockton-on-Tees 001,E02002535,10032,9428,604,169,403,32,555
Stockton-on-Tees 002,E02002536,9595,8743,852,147,687,18,569
Stockton-on-Tees 003,E02002537,9013,8149,864,295,552,17,678
Stockton-on-Tees 004,E02002538,5989,5520,469,80,376,13,382
Stockton-on-Tees 005,E02002539,8793,8169,624,90,496,38,613
Stockton-on-Tees 006,E02002540,6286,5852,434,94,321,19,357
Stockton-on-Tees 007,E02002541,6301,5720,581,64,505,12,481
Stockton-on-Tees 008,E02002542,8341,7610,731,193,525,13,519
Stockton-on-Tees 009,E02002543,8255,7365,890,140,722,28,570
Stockton-on-Tees 010,E02002544,8594,7326,1268,195,1057,16,998
Stockton-on-Tees 011,E02002545,5395,5069,326,15,299,12,414
Stockton-on-Tees 012,E02002546,7739,6811,928,158,742,28,675
Stockton-on-Tees 013,E02002547,6343,5934,409,42,342,25,431
Stockton-on-Tees 014,E02002548,11233,9085,2148,416,1608,124,1405
Stockton-on-Tees 015,E02002549,7844,7369,475,77,373,25,489
Stockton-on-Tees 016,E02002550,6398,5783,615,80,517,18,572
Stockton-on-Tees 017,E02002551,6531,4804,1727,290,1292,145,1005
Stockton-on-Tees 018,E02002552,6814,6101,713,145,549,19,506
Stockton-on-Tees 019,E02002553,5891,5270,621,103,502,16,415
Stockton-on-Tees 020,E02002554,5505,5024,481,141,320,20,387
Stockton-on-Tees 021,E02002555,9928,9066,862,179,633,50,667
Stockton-on-Tees 022,E02002556,7160,6682,478,38,420,20,577
Stockton-on-Tees 023,E02002557,13885,12421,1464,341,1045,78,882
Stockton-on-Tees 024,E02002558,9745,8609,1136,196,848,92,795
Gateshead 001,E02001682,7853,7131,722,173,524,25,449
Gateshead 002,E02001683,9134,8299,835,254,560,21,509
Gateshead 003,E02001684,6867,5993,874,124,728,22,533
Gateshead 004,E02001685,8256,7414,842,200,615,27,471
Gateshead 005,E02001686,7099,6517,582,107,455,20,481
Gateshead 007,E02001688,7726,6677,1049,168,839,42,827
Gateshead 008,E02001689,8243,6890,1353,204,1005,144,882
Gateshead 009,E02001690,7579,6846,733,150,552,31,548
Gateshead 010,E02001691,8327,6888,1439,203,1092,144,1131
Gateshead 011,E02001692,6414,5856,558,60,486,12,485
Gateshead 012,E02001693,5613,5045,568,101,460,7,429
Gateshead 013,E02001694,6565,6152,413,75,330,8,439
Gateshead 014,E02001695,6345,5935,410,70,324,16,325
Gateshead 015,E02001696,9399,8764,635,125,489,21,505
Gateshead 016,E02001697,7823,7205,618,55,536,27,520
Gateshead 017,E02001698,7272,6813,459,80,363,16,377
Gateshead 018,E02001699,6980,6498,482,38,432,12,449
Gateshead 019,E02001700,10606,9946,660,105,534,21,628
Gateshead 020,E02001701,6320,5909,411,54,339,18,362
Gateshead 021,E02001702,8055,7446,609,111,473,25,465
Gateshead 022,E02001703,5702,5422,280,35,230,15,314
Gateshead 023,E02001704,7156,6632,524,114,400,10,421
Gateshead 024,E02001705,7045,6392,653,225,420,8,451
Gateshead 025,E02001706,6653,6073,580,127,441,12,366
Gateshead 026,E02001707,8367,7638,729,225,481,23,471
Gateshead 027,E02006841,7487,5873,1614,150,1311,153,1331
Gateshead 028,E02006842,5328,4532,796,50,684,62,538
Newcastle upon Tyne 001,E02001708,9735,8740,995,119,790,86,603
Newcastle upon Tyne 002,E02001709,10237,9204,1033,153,809,71,770
Newcastle upon Tyne 003,E02001710,9826,8837,989,172,754,63,758
Newcastle upon Tyne 004,E02001711,9703,8782,921,188,696,37,712
Newcastle upon Tyne 005,E02001712,9924,7987,1937,172,1565,200,1374
Newcastle upon Tyne 006,E02001713,10492,9226,1266,134,1011,121,996
Newcastle upon Tyne 007,E02001714,9817,8687,1130,152,892,86,926
Newcastle upon Tyne 008,E02001715,11323,10256,1067,172,835,60,966
Newcastle upon Tyne 011,E02001718,5655,5235,420,53,358,9,337
Newcastle upon Tyne 012,E02001719,9339,7906,1433,83,1192,158,1265
Newcastle upon Tyne 013,E02001720,9726,4380,5346,1010,4050,286,3002
Newcastle upon Tyne 014,E02001721,10261,9407,854,257,578,19,592
Newcastle upon Tyne 015,E02001722,9667,8900,767,179,571,17,675
Newcastle upon Tyne 016,E02001723,6368,5637,731,57,591,83,552
Newcastle upon Tyne 017,E02001724,9211,4351,4860,580,3940,340,3062
Newcastle upon Tyne 018,E02001725,10336,5947,4389,690,3404,295,2773
Newcastle upon Tyne 019,E02001726,11839,10280,1559,132,1301,126,1193
Newcastle upon Tyne 020,E02001727,8530,7959,571,83,466,22,534
Newcastle upon Tyne 021,E02001728,9734,8975,759,165,574,20,672
Newcastle upon Tyne 022,E02001729,12296,8192,4104,532,2638,934,2898
Newcastle upon Tyne 023,E02001730,12926,6125,6801,1073,4950,778,3962
Newcastle upon Tyne 024,E02001731,12281,7102,5179,476,3567,1136,3444
Newcastle upon Tyne 025,E02001732,5031,4541,490,76,387,27,410
Newcastle upon Tyne 026,E02001733,11885,10228,1657,242,1287,128,1310
Newcastle upon Tyne 027,E02001734,7663,6664,999,163,767,69,630
Newcastle upon Tyne 028,E02001735,6614,6079,535,86,426,23,447
Newcastle upon Tyne 029,E02001736,12990,10708,2282,627,1219,436,1564
Newcastle upon Tyne 030,E02001737,6054,5374,680,121,530,29,550
Newcastle upon Tyne 031,E02006893,10714,10050,664,113,530,21,521
North Tyneside 001,E02001738,5625,5250,375,52,291,32,312
North Tyneside 002,E02001739,7508,6909,599,140,447,12,452
North Tyneside 003,E02001740,5789,5344,445,73,358,14,417
North Tyneside 004,E02001741,6967,6466,501,121,365,15,389
North Tyneside 005,E02001742,6037,5547,490,62,413,15,410
North Tyneside 006,E02001743,7569,6657,912,97,767,48,751
North Tyneside 007,E02001744,6531,5977,554,57,472,25,472
North Tyneside 008,E02001745,6357,5843,514,106,391,17,453
North Tyneside 009,E02001746,8334,7622,712,90,590,32,647
North Tyneside 010,E02001747,6180,5698,482,49,402,31,433
North Tyneside 011,E02001748,7532,6692,840,96,730,14,566
North Tyneside 012,E02001749,6161,5670,491,50,423,18,424
North Tyneside 013,E02001750,6636,6157,479,45,412,22,407
North Tyneside 014,E02001751,6039,5594,445,52,364,29,360
North Tyneside 015,E02001752,6281,5728,553,69,458,26,460
North Tyneside 016,E02001753,6304,5485,819,127,646,46,580
North Tyneside 017,E02001754,6025,5359,666,49,587,30,565
North Tyneside 018,E02001755,7985,7263,722,61,609,52,628
North Tyneside 019,E02001756,9258,8220,1038,206,802,30,707
North Tyneside 020,E02001757,5918,5497,421,30,371,20,356
North Tyneside 021,E02001758,5599,5241,358,59,293,6,361
North Tyneside 022,E02001759,6294,5456,838,81,730,27,678
North Tyneside 023,E02001760,7775,6911,864,191,651,22,605
North Tyneside 024,E02001761,5397,5010,387,54,320,13,340
North Tyneside 025,E02001762,5588,5230,358,59,291,8,405
North Tyneside 026,E02001763,6307,5810,497,80,406,11,483
North Tyneside 027,E02001764,7559,6619,940,151,771,18,685
North Tyneside 028,E02001765,7281,6304,977,135,814,28,528
North Tyneside 029,E02001766,6927,6022,905,125,742,38,700
North Tyneside 030,E02001767,7038,6350,688,100,562,26,718
South Tyneside 001,E02001768,8446,7416,1030,193,762,75,671
South Tyneside 002,E02001769,7396,6353,1043,174,807,62,704
South Tyneside 003,E02001770,6552,5732,820,82,685,53,561
South Tyneside 004,E02001771,6405,5846,559,66,471,22,449
South Tyneside 005,E02001772,5412,4846,566,48,505,13,456
South Tyneside 006,E02001773,5457,5181,276,24,238,14,290
South Tyneside 007,E02001774,5495,4951,544,105,422,17,410
South Tyneside 008,E02001775,5637,5251,386,64,318,4,367
South Tyneside 009,E02001776,8387,7536,851,180,647,24,637
South Tyneside 010,E02001777,6330,5793,537,93,439,5,439
South Tyneside 011,E02001778,6152,5394,758,110,621,27,665
South Tyneside 012,E02001779,5449,4963,486,29,445,12,410
South Tyneside 013,E02001780,5194,4871,323,37,261,25,285
South Tyneside 014,E02001781,5419,5025,394,56,328,10,356
South Tyneside 015,E02001782,8656,8062,594,94,480,20,429
South Tyneside 016,E02001783,6679,6243,436,93,331,12,528
South Tyneside 017,E02001784,6837,6406,431,74,340,17,337
South Tyneside 018,E02001785,7902,7414,488,69,404,15,426
South Tyneside 019,E02001786,7015,6576,439,68,358,13,447
South Tyneside 020,E02001787,5623,5270,353,90,256,7,284
South Tyneside 021,E02001788,5899,5489,410,103,293,14,303
South Tyneside 022,E02001789,5829,5435,394,58,289,47,352
South Tyneside 023,E02001790,5956,5566,390,50,325,15,338
Sunderland 001,E02001791,5788,5496,292,18,265,9,291
Sunderland 002,E02001792,7133,6634,499,71,408,20,385
Sunderland 003,E02001793,8383,7778,605,230,357,18,549
Sunderland 004,E02001794,8674,8057,617,183,427,7,426
Sunderland 005,E02001795,7585,6897,688,149,521,18,638
Sunderland 006,E02001796,9277,8073,1204,238,748,218,896
Sunderland 007,E02001797,5851,5424,427,64,343,20,366
Sunderland 008,E02001798,8260,7697,563,112,441,10,480
Sunderland 009,E02001799,10004,8964,1040,368,631,41,651
Sunderland 010,E02001800,7275,6710,565,92,457,16,428
Sunderland 011,E02001801,6623,5119,1504,140,1074,290,1195
Sunderland 012,E02001802,6302,5769,533,68,454,11,438
Sunderland 013,E02001803,8644,5907,2737,398,2001,338,1612
Sunderland 014,E02001804,6457,5967,490,61,413,16,350
Sunderland 015,E02001805,5858,5335,523,53,450,20,524
Sunderland 016,E02001806,8565,7156,1409,308,1030,71,941
Sunderland 017,E02001807,7297,6727,570,119,418,33,558
Sunderland 018,E02001808,6058,5252,806,81,640,85,677
Sunderland 019,E02001809,6559,6123,436,54,365,17,444
Sunderland 020,E02001810,8582,7958,624,133,475,16,529
Sunderland 021,E02001811,9184,8512,672,154,496,22,502
Sunderland 022,E02001812,10468,9587,881,90,703,88,702
Sunderland 023,E02001813,10093,9327,766,179,564,23,518
Sunderland 024,E02001814,6407,5904,503,56,407,40,380
Sunderland 025,E02001815,10328,9646,682,121,535,26,646
Sunderland 026,E02001816,6913,6405,508,96,408,4,426
Sunderland 027,E02001817,6290,5787,503,148,345,10,400
Sunderland 028,E02001818,8435,7791,644,116,511,17,525
Sunderland 029,E02001819,6941,6523,418,41,362,15,377
Sunderland 030,E02001820,8528,7984,544,86,426,32,492
Sunderland 031,E02001821,5948,5588,360,32,313,15,309
Sunderland 032,E02001822,7597,6987,610,66,523,21,450
Sunderland 033,E02001823,7129,6586,543,103,428,12,378
Sunderland 034,E02001824,8406,7784,622,124,484,14,516
Sunderland 035,E02001825,7065,6601,464,107,348,9,446
Sunderland 036,E02001826,6599,5996,603,143,449,11,327
Blackburn with Darwen 001,E02002615,9298,8595,703,121,548,34,709
Blackburn with Darwen 002,E02002616,8617,7930,687,117,527,43,636
Blackburn with Darwen 003,E02002617,8913,8288,625,168,388,69,548
Blackburn with Darwen 004,E02002618,7543,7105,438,69,322,47,473
Blackburn with Darwen 005,E02002619,8784,7838,946,140,723,83,711
Blackburn with Darwen 006,E02002620,8465,7354,1111,171,862,78,821
Blackburn with Darwen 007,E02002621,8381,7590,791,182,540,69,546
Blackburn with Darwen 008,E02002622,10137,9033,1104,315,723,66,931
Blackburn with Darwen 009,E02002623,10066,8607,1459,347,1048,64,1104
Blackburn with Darwen 010,E02002624,8121,7581,540,84,433,23,542
Blackburn with Darwen 011,E02002625,9930,8906,1024,163,804,57,845
Blackburn with Darwen 012,E02002626,7216,6624,592,90,489,13,534
Blackburn with Darwen 013,E02002627,7703,7122,581,109,456,16,545
Blackburn with Darwen 014,E02002628,7056,6290,766,129,614,23,610
Blackburn with Darwen 015,E02002629,5783,5054,729,168,536,25,563
Blackburn with Darwen 016,E02002630,6106,5304,802,109,673,20,616
Blackburn with Darwen 017,E02002631,9101,8339,762,205,524,33,637
Blackburn with Darwen 018,E02002632,6269,5864,405,74,308,23,423
Blackpool 001,E02002633,7808,7140,668,84,555,29,566
Blackpool 002,E02002634,8256,7488,768,67,684,17,603
Blackpool 003,E02002635,7996,7241,755,67,660,28,578
Blackpool 004,E02002636,8374,7590,784,94,673,17,660
Blackpool 005,E02002637,6189,5721,468,50,406,12,512
Blackpool 006,E02002638,6406,5157,1249,180,1017,52,999
Blackpool 007,E02002639,5770,5093,677,136,537,4,581
Blackpool 008,E02002640,7317,6139,1178,193,952,33,974
Blackpool 009,E02002641,8268,7311,957,140,767,50,864
Blackpool 010,E02002642,7081,5530,1551,257,1244,50,1311
Blackpool 011,E02002643,7502,6417,1085,152,867,66,1055
Blackpool 012,E02002644,8035,7366,669,98,542,29,692
Blackpool 013,E02002645,5777,4578,1199,230,929,40,1056
Blackpool 014,E02002646,7102,6374,728,115,581,32,607
Blackpool 015,E02002647,8203,7229,974,117,839,18,832
Blackpool 016,E02002648,7329,6569,760,83,657,20,670
Blackpool 017,E02002649,8587,7567,1020,148,823,49,766
Blackpool 018,E02002650,7983,7331,652,102,535,15,588
Blackpool 019,E02002651,8082,7391,691,98,562,31,564
Cheshire East 022,E02003811,5893,5480,413,33,342,38,371
Cheshire East 023,E02003812,5605,5188,417,93,306,18,336
Cheshire East 024,E02003813,6248,5725,523,87,406,30,383
Cheshire East 025,E02003814,7347,6731,616,110,485,21,554
Cheshire East 026,E02003815,6818,6199,619,170,443,6,434
Cheshire East 027,E02003816,6823,6048,775,158,592,25,535
Cheshire East 028,E02003817,7029,6484,545,104,415,26,439
Cheshire East 029,E02003818,5812,5358,454,90,342,22,432
Cheshire East 030,E02003819,5748,5284,464,57,373,34,389
Cheshire East 031,E02003820,6792,6190,602,116,464,22,483
Cheshire East 032,E02003821,5436,4966,470,114,335,21,379
Cheshire East 033,E02003822,10634,9910,724,101,594,29,600
Cheshire East 040,E02003823,6525,6005,520,103,402,15,461
Cheshire East 042,E02003824,5250,4695,555,102,438,15,454
Cheshire East 034,E02003825,6800,6214,586,88,461,37,466
Cheshire East 035,E02003826,7513,6861,652,82,554,16,569
Cheshire East 036,E02003827,8707,7562,1145,197,867,81,890
Cheshire East 037,E02003828,6713,5965,748,75,644,29,562
Cheshire East 038,E02003829,6436,5172,1264,142,1076,46,781
Cheshire East 039,E02003830,7294,6195,1099,164,839,96,920
Cheshire East 041,E02003831,9062,8289,773,120,624,29,611
Cheshire East 043,E02003832,6008,4823,1185,187,881,117,800
Cheshire East 044,E02003833,6374,5940,434,31,388,15,431
Cheshire East 045,E02003834,6737,5741,996,141,792,63,761
Cheshire East 046,E02003835,7853,7406,447,39,385,23,478
Cheshire East 047,E02003836,6898,6089,809,153,625,31,500
Cheshire East 049,E02003837,12035,10752,1283,195,1023,65,1100
Cheshire East 048,E02003838,6104,5674,430,59,350,21,327
Cheshire East 050,E02003839,7066,6200,866,124,701,41,566
Cheshire East 051,E02003840,10043,9191,852,155,647,50,584
Cheshire East 001,E02003853,5688,5289,399,70,306,23,346
Cheshire East 002,E02003854,6402,5953,449,79,352,18,453
Cheshire East 003,E02003855,6614,6021,593,109,444,40,429
Cheshire East 004,E02003856,10241,9195,1046,266,729,51,690
Cheshire East 005,E02003857,6396,5636,760,96,589,75,544
Cheshire East 006,E02003858,6605,5871,734,58,561,115,673
Cheshire East 007,E02003859,11807,10480,1327,143,1123,61,876
Cheshire East 008,E02003860,6990,6368,622,136,454,32,558
Cheshire East 009,E02003861,6418,5842,576,137,391,48,411
Cheshire East 011,E02003862,5128,4683,445,55,348,42,427
Cheshire East 010,E02003863,6773,6079,694,117,519,58,553
Cheshire East 012,E02003864,8026,7073,953,179,676,98,651
Cheshire East 013,E02003865,7593,6812,781,217,528,36,521
Cheshire East 014,E02003866,5961,5478,483,75,313,95,438
Cheshire East 015,E02003867,7544,6837,707,107,535,65,545
Cheshire East 016,E02003868,8257,7461,796,124,626,46,627
Cheshire East 017,E02003869,7020,6458,562,55,486,21,554
Cheshire East 018,E02003870,10288,8658,1630,357,1141,132,1133
Cheshire East 019,E02003871,6996,6454,542,63,453,26,422
Cheshire East 020,E02003872,9657,8937,720,94,589,37,612
Cheshire East 021,E02003873,6120,5489,631,92,496,43,481
Cheshire West and Chester 022,E02003794,8609,7959,650,104,514,32,522
Cheshire West and Chester 025,E02003795,5595,5008,587,84,446,57,628
Cheshire West and Chester 027,E02003796,7178,6511,667,110,535,22,673
Cheshire West and Chester 028,E02003797,9547,8234,1313,127,1122,64,1034
Cheshire West and Chester 029,E02003798,6060,5576,484,93,377,14,454
Cheshire West and Chester 031,E02003799,7039,6381,658,132,500,26,406
Cheshire West and Chester 030,E02003800,6273,5807,466,82,350,34,372
Cheshire West and Chester 032,E02003801,7019,6501,518,23,467,28,515
Cheshire West and Chester 033,E02003802,8051,5928,2123,262,1691,170,1446
Cheshire West and Chester 034,E02003803,8909,5189,3720,1170,2367,183,1895
Cheshire West and Chester 036,E02003804,6773,5759,1014,84,878,52,906
Cheshire West and Chester 039,E02003805,6195,5719,476,62,382,32,468
Cheshire West and Chester 041,E02003806,5942,5422,520,64,424,32,346
Cheshire West and Chester 043,E02003807,8181,7245,936,154,686,96,788
Cheshire West and Chester 044,E02003808,6419,5820,599,149,425,25,516
Cheshire West and Chester 046,E02003809,7496,6825,671,130,495,46,554
Cheshire West and Chester 047,E02003810,7973,7349,624,186,396,42,499
Cheshire West and Chester 001,E02003841,7636,6853,783,187,566,30,508
Cheshire West and Chester 004,E02003842,5332,4989,343,51,275,17,359
Cheshire West and Chester 005,E02003843,5852,5411,441,50,379,12,459
Cheshire West and Chester 006,E02003844,6772,6263,509,93,383,33,452
Cheshire West and Chester 007,E02003845,8128,6915,1213,206,957,50,766
Cheshire West and Chester 008,E02003846,6781,6270,511,58,440,13,486
Cheshire West and Chester 009,E02003847,9625,9055,570,81,450,39,594
Cheshire West and Chester 010,E02003848,5113,4651,462,46,401,15,363
Cheshire West and Chester 011,E02003849,6855,6147,708,156,529,23,538
Cheshire West and Chester 013,E02003850,5351,5054,297,22,261,14,335
Cheshire West and Chester 014,E02003851,5891,5550,341,45,273,23,439
Cheshire West and Chester 016,E02003852,6870,6420,450,69,351,30,428
Cheshire West and Chester 002,E02003874,9077,8380,697,189,460,48,505
Cheshire West and Chester 003,E02003875,6414,5989,425,55,353,17,463
Cheshire West and Chester 012,E02003876,5614,5220,394,123,263,8,299
Cheshire West and Chester 015,E02003877,9214,8528,686,150,509,27,576
Cheshire West and Chester 017,E02003878,8009,7396,613,61,512,40,548
Cheshire West and Chester 018,E02003879,6270,5438,832,135,658,39,665
Cheshire West and Chester 019,E02003880,6391,5946,445,107,328,10,362
Cheshire West and Chester 020,E02003881,6069,5337,732,118,573,41,573
Cheshire West and Chester 021,E02003882,9513,8681,832,187,624,21,681
Cheshire West and Chester 023,E02003883,9893,9047,846,128,656,62,820
Cheshire West and Chester 024,E02003884,7897,7289,608,89,471,48,567
Cheshire West and Chester 026,E02003885,5646,5192,454,61,360,33,418
Cheshire West and Chester 035,E02003886,6647,6091,556,108,443,5,418
Cheshire West and Chester 037,E02003887,6137,5714,423,52,358,13,416
Cheshire West and Chester 038,E02003888,6124,5532,592,122,443,27,401
Cheshire West and Chester 040,E02003889,5643,5159,484,87,384,13,380
Cheshire West and Chester 042,E02003890,5930,5415,515,83,423,9,442
Cheshire West and Chester 045,E02003891,5655,5267,388,73,287,28,411
Halton 001,E02002574,7137,6635,502,62,422,18,419
Halton 002,E02002575,9666,8969,697,156,512,29,572
Halton 003,E02002576,7369,6791,578,114,455,9,465
Halton 004,E02002577,7495,6915,580,119,431,30,449
Halton 005,E02002578,7725,7236,489,63,406,20,523
Halton 006,E02002579,7805,7228,577,107,450,20,503
Halton 007,E02002580,7512,6565,947,247,655,45,656
Halton 008,E02002581,7353,6841,512,60,420,32,451
Halton 009,E02002582,8192,7586,606,58,518,30,510
Halton 010,E02002583,6851,6321,530,140,381,9,444
Halton 011,E02002584,7460,6946,514,73,430,11,556
Halton 012,E02002585,10492,9172,1320,337,955,28,881
Halton 013,E02002586,9816,8965,851,181,653,17,670
Halton 014,E02002587,6925,6340,585,95,475,15,620
Halton 015,E02002588,7500,6937,563,116,424,23,460
Halton 016,E02002589,6448,6082,366,66,283,17,379
Warrington 001,E02002590,7215,6289,926,86,804,36,719
Warrington 002,E02002591,6435,5909,526,121,391,14,434
Warrington 003,E02002592,6348,5859,489,83,383,23,377
Warrington 004,E02002593,5236,4834,402,67,301,34,364
Warrington 005,E02002594,5465,4969,496,100,373,23,464
Warrington 006,E02002595,7920,7112,808,143,612,53,616
Warrington 007,E02002596,8503,7723,780,184,528,68,668
Warrington 008,E02002597,9001,8263,738,132,585,21,732
Warrington 009,E02002598,7690,6887,803,89,684,30,543
Warrington 010,E02002599,10910,9972,938,123,773,42,815
Warrington 011,E02002600,9183,8304,879,89,727,63,802
Warrington 012,E02002601,7931,7451,480,52,410,18,471
Warrington 013,E02002602,7345,6399,946,179,717,50,710
Warrington 014,E02002603,7156,6764,392,41,324,27,410
Warrington 015,E02002604,7693,7245,448,82,352,14,462
Warrington 016,E02002605,9234,8608,626,110,494,22,593
Warrington 017,E02002606,10174,8328,1846,237,1459,150,1221
Warrington 018,E02002607,9964,8373,1591,144,1263,184,1132
Warrington 019,E02002608,8543,8080,463,77,362,24,387
Warrington 020,E02002609,8134,7070,1064,185,813,66,763
Warrington 021,E02002610,12350,11139,1211,377,755,79,831
Warrington 022,E02002611,7952,7364,588,102,467,19,458
Warrington 023,E02002612,9352,8471,881,151,692,38,663
Warrington 024,E02002613,6398,5700,698,35,634,29,563
Warrington 025,E02002614,6096,5688,408,71,311,26,385
Allerdale 001,E02003965,10902,10056,846,394,429,23,487
Allerdale 002,E02003966,7063,6594,469,66,369,34,421
Allerdale 003,E02003967,8285,7691,594,199,383,12,461
Allerdale 004,E02003968,8619,7907,712,268,429,15,464
Allerdale 005,E02003969,6690,6120,570,213,344,13,405
Allerdale 006,E02003970,7750,6846,904,180,661,63,519
Allerdale 007,E02003971,8021,7360,661,151,460,50,550
Allerdale 008,E02003972,9232,8424,808,251,540,17,472
Allerdale 009,E02003973,8751,8026,725,217,489,19,556
Allerdale 010,E02003974,7796,7206,590,154,427,9,370
Allerdale 011,E02003975,6455,5962,493,119,361,13,397
Allerdale 012,E02003976,6858,6199,659,225,357,77,425
Barrow-in-Furness 001,E02003977,6407,5901,506,122,365,19,463
Barrow-in-Furness 002,E02003978,5935,5472,463,104,353,6,348
Barrow-in-Furness 003,E02003979,7709,7167,542,89,421,32,413
Barrow-in-Furness 004,E02003980,6705,5999,706,176,514,16,577
Barrow-in-Furness 005,E02003981,6829,6179,650,129,496,25,529
Barrow-in-Furness 006,E02003982,7594,7029,565,116,428,21,477
Barrow-in-Furness 007,E02003983,7733,7081,652,121,516,15,547
Barrow-in-Furness 008,E02003984,6908,5863,1045,243,775,27,641
Barrow-in-Furness 009,E02003985,6679,6152,527,112,401,14,462
Barrow-in-Furness 010,E02003986,6588,5960,628,158,450,20,591
Carlisle 001,E02003987,6056,5615,441,165,240,36,326
Carlisle 002,E02003988,6629,5971,658,196,413,49,437
Carlisle 003,E02003989,7609,7003,606,108,467,31,539
Carlisle 004,E02003990,9757,8957,800,125,627,48,802
Carlisle 005,E02003991,7721,7250,471,64,384,23,355
Carlisle 006,E02003992,8594,6698,1896,417,1360,119,1182
Carlisle 007,E02003993,8582,7940,642,122,483,37,483
Carlisle 008,E02003994,7515,6553,962,158,761,43,758
Carlisle 009,E02003995,9494,8654,840,170,651,19,554
Carlisle 010,E02003996,9698,8147,1551,222,1250,79,1116
Carlisle 011,E02003997,9581,8626,955,276,658,21,581
Carlisle 012,E02003998,6908,6371,537,86,436,15,401
Carlisle 013,E02003999,9380,8590,790,113,615,62,595
Copeland 001,E02004000,5506,5051,455,98,348,9,254
Copeland 002,E02004001,5612,5093,519,110,386,23,397
Copeland 003,E02004002,10332,9519,813,225,542,46,614
Copeland 004,E02004003,12019,11062,957,385,545,27,597
Copeland 005,E02004004,9398,8746,652,280,360,12,483
Copeland 006,E02004005,8194,7585,609,223,367,19,429
Copeland 007,E02004006,9044,8329,715,183,457,75,474
Copeland 008,E02004007,10498,9365,1133,503,595,35,522
Eden 001,E02004008,6394,5904,490,139,339,12,405
Eden 002,E02004009,6078,5500,578,64,481,33,510
Eden 003,E02004010,7119,6227,892,262,602,28,577
Eden 004,E02004011,9815,8899,916,224,660,32,603
Eden 005,E02004012,5666,5107,559,103,412,44,416
Eden 006,E02004013,9903,9100,803,287,485,31,502
Eden 007,E02004014,7589,6922,667,316,323,28,401
South Lakeland 001,E02004015,6494,5523,971,275,591,105,824
South Lakeland 002,E02004016,8401,7474,927,299,542,86,575
South Lakeland 003,E02004017,8391,7566,825,185,582,58,638
South Lakeland 004,E02004018,8147,7111,1036,243,732,61,611
South Lakeland 005,E02004019,7993,7372,621,83,499,39,450
South Lakeland 006,E02004020,8283,7629,654,118,508,28,595
South Lakeland 007,E02004021,5276,4737,539,82,423,34,366
South Lakeland 008,E02004022,5575,5100,475,104,331,40,363
South Lakeland 009,E02004023,6245,5436,809,201,492,116,422
South Lakeland 010,E02004024,7185,6647,538,83,418,37,476
South Lakeland 011,E02004025,8073,7312,761,217,479,65,413
South Lakeland 012,E02004026,8022,7186,836,259,535,42,517
South Lakeland 013,E02004027,7814,7082,732,237,454,41,364
South Lakeland 014,E02004028,7759,7189,570,117,432,21,456
Bolton 001,E02000984,7782,7145,637,139,470,28,490
Bolton 002,E02000985,7569,7059,510,67,415,28,491
Bolton 003,E02000986,8365,7564,801,118,661,22,545
Bolton 004,E02000987,7195,6493,702,154,538,10,500
Bolton 005,E02000988,8407,7563,844,152,640,52,678
Bolton 006,E02000989,8242,7712,530,91,411,28,486
Bolton 007,E02000990,7636,6987,649,119,503,27,599
Bolton 008,E02000991,7682,7010,672,96,539,37,566
Bolton 009,E02000992,5781,5340,441,71,356,14,351
Bolton 010,E02000993,7142,6257,885,178,686,21,737
Bolton 011,E02000994,7914,7030,884,146,669,69,669
Bolton 012,E02000995,8163,7511,652,152,484,16,565
Bolton 013,E02000996,7869,7101,768,183,566,19,521
Bolton 014,E02000997,5676,5216,460,52,393,15,423
Bolton 015,E02000998,8613,7293,1320,222,994,104,924
Bolton 016,E02000999,7435,6046,1389,146,1118,125,975
Bolton 017,E02001000,9145,7912,1233,192,949,92,997
Bolton 018,E02001001,8101,7182,919,93,771,55,841
Bolton 019,E02001002,9445,8735,710,101,581,28,665
Bolton 020,E02001003,7277,6819,458,52,382,24,457
Bolton 021,E02001004,8240,7311,929,186,591,152,736
Bolton 022,E02001005,7937,6834,1103,140,883,80,761
Bolton 023,E02001006,7709,6928,781,98,604,79,701
Bolton 024,E02001007,10271,9497,774,264,493,17,538
Bolton 025,E02001008,8140,7285,855,97,645,113,697
Bolton 026,E02001009,6689,5909,780,114,621,45,597
Bolton 027,E02001010,5867,5176,691,80,569,42,514
Bolton 028,E02001011,9855,8995,860,157,670,33,620
Bolton 029,E02001012,7833,7201,632,68,524,40,545
Bolton 030,E02001013,6029,5555,474,50,395,29,429
Bolton 031,E02001014,8168,7466,702,167,513,22,638
Bolton 032,E02001015,7913,6934,979,225,720,34,613
Bolton 033,E02001016,8243,7501,742,96,622,24,592
Bolton 034,E02001017,10849,9971,878,214,628,36,657
Bolton 035,E02001018,7604,7026,578,92,462,24,500
Bury 001,E02001019,8967,8105,862,181,643,38,638
Bury 002,E02001020,5933,5486,447,43,386,18,415
Bury 003,E02001021,7806,7127,679,93,570,16,622
Bury 004,E02001022,7860,7172,688,111,549,28,503
Bury 005,E02001023,5833,5402,431,56,362,13,521
Bury 006,E02001024,8083,7510,573,108,438,27,480
Bury 007,E02001025,7608,6768,840,149,635,56,640
Bury 008,E02001026,8964,7718,1246,235,928,83,1018
Bury 009,E02001027,6787,5887,900,103,766,31,612
Bury 010,E02001028,7430,7057,373,70,284,19,429
Bury 011,E02001029,6974,6223,751,121,583,47,572
Bury 012,E02001030,5817,5441,376,47,318,11,382
Bury 013,E02001031,6464,5940,524,58,431,35,617
Bury 014,E02001032,7552,6927,625,119,483,23,489
Bury 015,E02001033,5613,5050,563,95,454,14,504
Bury 016,E02001034,7766,6714,1052,199,827,26,666
Bury 017,E02001035,7200,6855,345,33,293,19,444
Bury 018,E02001036,7253,6582,671,96,557,18,662
Bury 019,E02001037,7118,6534,584,96,452,36,502
Bury 020,E02001038,5568,4936,632,84,522,26,520
Bury 021,E02001039,8174,7468,706,133,508,65,608
Bury 022,E02001040,6020,5582,438,30,387,21,488
Bury 023,E02001041,7616,6837,779,82,662,35,655
Bury 024,E02001042,6193,5523,670,45,582,43,663
Bury 025,E02001043,5468,4918,550,76,450,24,443
Bury 026,E02001044,8993,8316,677,117,462,98,605
Manchester 001,E02001045,7927,7241,686,144,512,30,588
Manchester 002,E02001046,9390,8418,972,183,723,66,881
Manchester 003,E02001047,9870,8871,999,113,853,33,744
Manchester 004,E02001048,8473,7541,932,102,736,94,724
Manchester 005,E02001049,9633,8794,839,98,707,34,588
Manchester 006,E02001050,7166,6083,1083,107,826,150,1020
Manchester 007,E02001051,8038,6975,1063,163,812,88,840
Manchester 008,E02001052,12771,10680,2091,500,1174,417,1147
Manchester 009,E02001053,10042,8660,1382,223,982,177,1222
Manchester 011,E02001055,8601,7628,973,159,747,67,718
Manchester 012,E02001056,8169,7318,851,116,665,70,827
Manchester 013,E02001057,8107,5982,2125,211,1782,132,1171
Manchester 015,E02001059,9802,8078,1724,218,1354,152,1075
Manchester 017,E02001061,9002,7785,1217,173,921,123,1028
Manchester 018,E02001062,9958,7138,2820,171,1854,795,1938
Manchester 019,E02001063,10560,5823,4737,320,3323,1094,3410
Manchester 020,E02001064,9127,8113,1014,81,799,134,788
Manchester 021,E02001065,8679,7486,1193,147,920,126,986
Manchester 022,E02001066,11925,6800,5125,472,3849,804,3312
Manchester 023,E02001067,9514,8123,1391,180,1043,168,955
Manchester 024,E02001068,9667,8378,1289,204,887,198,994
Manchester 025,E02001069,10996,7250,3746,478,2616,652,2237
Manchester 026,E02001070,11895,6519,5376,368,4129,879,3835
Manchester 027,E02001071,13251,11027,2224,411,1346,467,1457
Manchester 028,E02001072,8606,6770,1836,192,1423,221,1271
Manchester 029,E02001073,9688,8026,1662,195,1356,111,1298
Manchester 030,E02001074,11579,9799,1780,103,1423,254,1236
Manchester 031,E02001075,8272,6736,1536,160,1116,260,1024
Manchester 032,E02001076,11579,4234,7345,1052,5706,587,4683
Manchester 033,E02001077,7750,6440,1310,161,1028,121,1038
Manchester 034,E02001078,10474,9092,1382,128,1068,186,1106
Manchester 035,E02001079,8982,6723,2259,133,1966,160,1723
Manchester 036,E02001080,9532,4707,4825,674,3847,304,3172
Manchester 037,E02001081,6213,5329,884,121,723,40,762
Manchester 038,E02001082,6792,4526,2266,156,1972,138,1786
Manchester 039,E02001083,7924,5378,2546,253,2116,177,1560
Manchester 040,E02001084,8620,6183,2437,127,2126,184,1878
Manchester 041,E02001085,8241,7531,710,74,560,76,631
Manchester 042,E02001086,6594,5449,1145,66,1005,74,885
Manchester 043,E02001087,9467,7496,1971,232,1577,162,1403
Manchester 044,E02001088,8891,8002,889,154,695,40,600
Manchester 045,E02001089,8017,6926,1091,107,879,105,1009
Manchester 046,E02001090,6686,5973,713,78,570,65,630
Manchester 047,E02001091,8157,7310,847,71,703,73,682
Manchester 048,E02001092,8506,7615,891,137,701,53,613
Manchester 049,E02001093,9207,8064,1143,171,887,85,808
Manchester 050,E02001094,9001,7960,1041,155,757,129,695
Manchester 051,E02001095,8303,7459,844,121,655,68,764
Manchester 052,E02001096,7395,6753,642,67,541,34,504
Manchester 053,E02001097,8054,7236,818,161,606,51,679
Manchester 054,E02006902,6061,3857,2204,138,1748,318,1599
Manchester 055,E02006912,8827,4026,4801,334,3687,780,2867
Manchester 056,E02006913,6679,5119,1560,100,1208,252,1170
Manchester 057,E02006914,6935,2704,4231,206,3313,712,2417
Manchester 058,E02006915,8720,7015,1705,171,1291,243,1342
Manchester 059,E02006916,5749,3959,1790,132,1454,204,1229
Manchester 060,E02006917,5063,2841,2222,172,1766,284,1376
Oldham 001,E02001098,6063,5617,446,79,338,29,439
Oldham 002,E02001099,6041,5441,600,76,503,21,410
Oldham 003,E02001100,6115,5640,475,104,351,20,447
Oldham 004,E02001101,5976,5601,375,32,337,6,357
Oldham 005,E02001102,6114,5644,470,53,398,19,424
Oldham 006,E02001103,5541,5079,462,61,376,25,383
Oldham 007,E02001104,6939,6410,529,113,406,10,584
Oldham 008,E02001105,5997,5497,500,91,388,21,377
Oldham 009,E02001106,6043,5501,542,80,446,16,466
Oldham 010,E02001107,6150,5695,455,46,382,27,523
Oldham 011,E02001108,5082,4495,587,130,438,19,497
Oldham 012,E02001109,7314,6598,716,116,561,39,643
Oldham 013,E02001110,6244,5671,573,86,469,18,484
Oldham 014,E02001111,6679,5845,834,179,594,61,744
Oldham 015,E02001112,5938,5562,376,56,302,18,382
Oldham 016,E02001113,9536,8675,861,336,436,89,619
Oldham 017,E02001114,8150,7358,792,106,665,21,563
Oldham 018,E02001115,5956,5389,567,71,488,8,421
Oldham 019,E02001116,6462,5739,723,126,542,55,530
Oldham 020,E02001117,5906,5296,610,123,462,25,375
Oldham 021,E02001118,6259,5722,537,72,452,13,414
Oldham 022,E02001119,10850,9978,872,313,424,135,691
Oldham 024,E02001121,6519,5822,697,102,483,112,680
Oldham 026,E02001123,6449,5722,727,112,595,20,581
Oldham 027,E02001124,5739,5225,514,48,438,28,521
Oldham 028,E02001125,8038,7310,728,77,617,34,517
Oldham 029,E02001126,7465,6726,739,161,530,48,604
Oldham 030,E02001127,7080,6420,660,153,493,14,515
Oldham 031,E02001128,7460,6758,702,102,586,14,544
Oldham 032,E02001129,5801,5191,610,109,465,36,514
Oldham 033,E02001130,5778,5402,376,59,299,18,297
Oldham 034,E02001131,5304,4987,317,65,230,22,287
Oldham 035,E02006860,13909,12671,1238,395,679,164,900
Rochdale 001,E02001132,6463,5758,705,170,508,27,551
Rochdale 002,E02001133,6175,5823,352,82,262,8,483
Rochdale 003,E02001134,6271,5759,512,80,423,9,440
Rochdale 004,E02001135,7607,6781,826,139,661,26,668
Rochdale 005,E02001136,9189,8202,987,141,797,49,770
Rochdale 006,E02001137,6198,5732,466,23,430,13,432
Rochdale 007,E02001138,8945,8244,701,127,532,42,573
Rochdale 008,E02001139,9257,8509,748,224,462,62,896
Rochdale 009,E02001140,7564,6708,856,136,681,39,649
Rochdale 010,E02001141,12440,10636,1804,433,1226,145,1489
Rochdale 011,E02001142,5925,5498,427,40,370,17,416
Rochdale 012,E02001143,10636,9524,1112,227,845,40,795
Rochdale 013,E02001144,6135,5582,553,79,462,12,462
Rochdale 014,E02001145,7109,6553,556,140,394,22,465
Rochdale 015,E02001146,9132,8197,935,224,608,103,700
Rochdale 016,E02001147,9047,7975,1072,248,811,13,798
Rochdale 017,E02001148,10016,9034,982,258,680,44,684
Rochdale 018,E02001149,9683,8412,1271,320,920,31,831
Rochdale 019,E02001150,8490,7784,706,193,497,16,621
Rochdale 020,E02001151,9414,8544,870,176,668,26,694
Rochdale 021,E02001152,9098,8194,904,171,705,28,808
Rochdale 022,E02001153,9998,8895,1103,359,704,40,533
Rochdale 023,E02001154,10226,9264,962,251,674,37,643
Rochdale 024,E02001155,6965,6242,723,97,608,18,589
Rochdale 025,E02001156,9716,9074,642,133,485,24,554
Salford 001,E02001157,7247,6428,819,155,643,21,540
Salford 002,E02001158,5934,5366,568,84,461,23,508
Salford 003,E02001159,5713,5088,625,88,509,28,512
Salford 004,E02001160,6208,5606,602,133,437,32,477
Salford 005,E02001161,5848,5348,500,40,432,28,425
Salford 006,E02001162,5808,5278,530,56,435,39,448
Salford 007,E02001163,9310,8459,851,143,682,26,694
Salford 008,E02001164,7114,5916,1198,104,1012,82,807
Salford 009,E02001165,6147,5713,434,43,366,25,431
Salford 010,E02001166,6997,6121,876,123,551,202,602
Salford 011,E02001167,6354,5456,898,63,720,115,562
Salford 012,E02001168,9406,8566,840,99,700,41,711
Salford 013,E02001169,10546,9836,710,149,524,37,653
Salford 014,E02001170,9692,8887,805,134,612,59,586
Salford 015,E02001171,5594,5260,334,33,290,11,388
Salford 016,E02001172,11945,9615,2330,377,1626,327,1369
Salford 017,E02001173,8362,6201,2161,280,1556,325,1472
Salford 018,E02001174,5640,4936,704,60,605,39,605
Salford 019,E02001175,6938,6324,614,83,500,31,566
Salford 020,E02001176,10930,9573,1357,231,1000,126,902
Salford 021,E02001177,11657,9902,1755,215,1378,162,1162
Salford 022,E02001178,10658,6727,3931,418,2861,652,2352
Salford 023,E02001179,5799,4894,905,64,753,88,666
Salford 024,E02001180,5878,4499,1379,162,960,257,857
Salford 025,E02001181,5690,5119,571,63,482,26,453
Salford 026,E02001182,6003,5219,784,128,548,108,532
Salford 027,E02001183,6044,5291,753,80,623,50,641
Salford 028,E02001184,10404,7209,3195,407,2418,370,1656
Salford 029,E02001185,10104,9330,774,256,492,26,550
Salford 030,E02001186,9963,8974,989,363,586,40,560
Stockport 001,E02001187,7188,6738,450,63,371,16,519
Stockport 002,E02001188,7941,7135,806,120,646,40,611
Stockport 003,E02001189,8382,7782,600,67,513,20,581
Stockport 004,E02001190,6686,6003,683,273,398,12,425
Stockport 005,E02001191,5841,5447,394,60,315,19,332
Stockport 006,E02001192,6446,5714,732,67,615,50,557
Stockport 007,E02001193,6099,5483,616,67,520,29,565
Stockport 008,E02001194,5886,5357,529,41,447,41,502
Stockport 009,E02001195,7449,6871,578,101,454,23,504
Stockport 010,E02001196,7547,7030,517,100,382,35,449
Stockport 011,E02001197,6225,5753,472,63,376,33,454
Stockport 012,E02001198,7545,6913,632,88,524,20,480
Stockport 013,E02001199,7806,7133,673,93,532,48,724
Stockport 014,E02001200,6421,5517,904,72,775,57,653
Stockport 015,E02001201,5784,5326,458,87,361,10,388
Stockport 016,E02001202,6094,5346,748,94,624,30,693
Stockport 017,E02001203,5796,5353,443,108,314,21,382
Stockport 018,E02001204,8938,8254,684,88,567,29,738
Stockport 019,E02001205,7783,7043,740,78,629,33,658
Stockport 020,E02001206,7003,6443,560,92,453,15,450
Stockport 021,E02001207,7013,6521,492,59,393,40,462
Stockport 022,E02001208,7222,6537,685,83,571,31,581
Stockport 023,E02001209,7734,6905,829,88,684,57,738
Stockport 024,E02001210,6901,6413,488,57,416,15,425
Stockport 025,E02001211,6010,5554,456,25,404,27,413
Stockport 026,E02001212,6492,5987,505,69,423,13,527
Stockport 027,E02001213,9129,8250,879,137,682,60,758
Stockport 028,E02001214,7452,6924,528,45,435,48,470
Stockport 029,E02001215,5804,5395,409,43,350,16,346
Stockport 030,E02001216,7310,6810,500,40,441,19,425
Stockport 031,E02001217,6581,5859,722,122,572,28,554
Stockport 032,E02001218,5860,5453,407,25,352,30,400
Stockport 033,E02001219,5455,5156,299,27,254,18,336
Stockport 034,E02001220,5536,5137,399,54,325,20,409
Stockport 035,E02001221,6003,5627,376,33,320,23,343
Stockport 036,E02001222,6206,5821,385,29,322,34,391
Stockport 037,E02001223,6893,6375,518,59,413,46,520
Stockport 038,E02001224,5816,5472,344,55,277,12,327
Stockport 039,E02001225,7078,6533,545,63,457,25,496
Stockport 040,E02001226,6810,6289,521,58,430,33,452
Stockport 041,E02001227,5699,5331,368,35,309,24,396
Stockport 042,E02001228,5411,5036,375,48,301,26,397
Tameside 001,E02001229,9731,8697,1034,281,725,28,812
Tameside 002,E02001230,6147,5753,394,51,320,23,390
Tameside 003,E02001231,7150,6684,466,72,379,15,400
Tameside 004,E02001232,8211,7365,846,166,637,43,769
Tameside 005,E02001233,7541,7008,533,88,427,18,474
Tameside 006,E02001234,7615,6869,746,129,579,38,649
Tameside 007,E02001235,6559,5897,662,72,559,31,627
Tameside 008,E02001236,5734,5151,583,111,450,22,528
Tameside 009,E02001237,6855,6078,777,166,591,20,568
Tameside 010,E02001238,7773,7243,530,98,415,17,525
Tameside 011,E02001239,9077,8319,758,153,584,21,608
Tameside 012,E02001240,6184,5710,474,78,378,18,411
Tameside 013,E02001241,9483,8264,1219,264,862,93,920
Tameside 014,E02001242,5707,5190,517,65,436,16,364
Tameside 015,E02001243,7872,7173,699,151,520,28,573
Tameside 016,E02001244,5511,5140,371,49,310,12,328
Tameside 017,E02001245,7848,7112,736,126,592,18,692
Tameside 018,E02001246,7289,6717,572,60,505,7,486
Tameside 019,E02001247,6926,6311,615,74,529,12,568
Tameside 020,E02001248,10258,9061,1197,247,927,23,734
Tameside 021,E02001249,6269,5639,630,76,537,17,617
Tameside 022,E02001250,6514,6079,435,70,352,13,437
Tameside 023,E02001251,6021,5536,485,94,370,21,482
Tameside 024,E02001252,7491,7017,474,103,360,11,432
Tameside 025,E02001253,5189,4755,434,44,383,7,349
Tameside 026,E02001254,5823,5488,335,38,287,10,344
Tameside 027,E02001255,6071,5581,490,177,307,6,305
Tameside 028,E02001256,10137,9089,1048,245,752,51,741
Tameside 029,E02001257,9106,8400,706,188,510,8,471
Tameside 030,E02001258,7232,6648,584,123,443,18,454
Trafford 001,E02001259,10177,8753,1424,263,953,208,1105
Trafford 002,E02001260,7632,7202,430,58,350,22,458
Trafford 003,E02001261,8277,7381,896,149,686,61,708
Trafford 004,E02001262,8461,7737,724,49,600,75,692
Trafford 005,E02001263,8054,7497,557,73,458,26,514
Trafford 006,E02001264,8149,7524,625,83,490,52,520
Trafford 007,E02001265,8108,7550,558,93,454,11,492
Trafford 008,E02001266,6649,5970,679,64,584,31,549
Trafford 009,E02001267,7422,6563,859,105,732,22,575
Trafford 010,E02001268,7196,6678,518,45,440,33,540
Trafford 011,E02001269,8266,7413,853,70,701,82,771
Trafford 012,E02001270,7861,6916,945,107,763,75,769
Trafford 013,E02001271,6547,6028,519,78,417,24,567
Trafford 014,E02001272,7850,7129,721,64,597,60,597
Trafford 015,E02001273,8882,7389,1493,197,1144,152,1130
Trafford 016,E02001274,7874,7338,536,53,436,47,553
Trafford 017,E02001275,8395,7551,844,314,492,38,453
Trafford 018,E02001276,7931,7318,613,58,536,19,628
Trafford 019,E02001277,8823,7872,951,141,759,51,654
Trafford 020,E02001278,8117,7371,746,57,635,54,628
Trafford 021,E02001279,8426,7770,656,70,536,50,585
Trafford 022,E02001280,8268,7602,666,81,558,27,595
Trafford 023,E02001281,7753,7125,628,43,538,47,572
Trafford 024,E02001282,9008,7684,1324,165,1047,112,1004
Trafford 025,E02001283,8645,7617,1028,108,794,126,778
Trafford 026,E02001284,8082,7202,880,138,684,58,799
Trafford 027,E02001285,7831,6885,946,128,731,87,790
Trafford 028,E02001286,7894,7240,654,61,523,70,598
Wigan 001,E02001287,5685,5308,377,58,290,29,367
Wigan 002,E02001288,7547,6950,597,109,451,37,529
Wigan 003,E02001289,10082,9540,542,113,409,20,536
Wigan 004,E02001290,6086,5640,446,68,368,10,358
Wigan 005,E02001291,7675,7066,609,135,450,24,528
Wigan 006,E02001292,7864,7020,844,138,599,107,615
Wigan 007,E02001293,6158,5688,470,70,385,15,406
Wigan 008,E02001294,7832,6908,924,132,731,61,793
Wigan 009,E02001295,7330,6460,870,197,641,32,577
Wigan 010,E02001296,8933,8028,905,239,644,22,754
Wigan 011,E02001297,6703,6174,529,89,422,18,449
Wigan 012,E02001298,8131,7373,758,198,537,23,653
Wigan 013,E02001299,8850,8004,846,153,667,26,678
Wigan 014,E02001300,7922,7220,702,118,575,9,526
Wigan 015,E02001301,8099,7039,1060,178,851,31,658
Wigan 016,E02001302,7846,7236,610,110,494,6,594
Wigan 017,E02001303,8530,7641,889,200,659,30,650
Wigan 018,E02001304,12240,11438,802,173,607,22,586
Wigan 019,E02001305,8197,7655,542,97,422,23,513
Wigan 020,E02001306,7302,6914,388,54,314,20,328
Wigan 021,E02001307,11264,10661,603,163,424,16,541
Wigan 022,E02001308,5992,5436,556,68,473,15,405
Wigan 023,E02001309,7669,6863,806,163,627,16,658
Wigan 024,E02001310,8988,7939,1049,219,794,36,758
Wigan 025,E02001311,8317,7556,761,172,570,19,615
Wigan 026,E02001312,7790,6965,825,157,655,13,624
Wigan 027,E02001313,7893,7133,760,153,591,16,605
Wigan 028,E02001314,8026,7419,607,103,479,25,545
Wigan 029,E02001315,7689,7142,547,52,474,21,513
Wigan 030,E02001316,6546,5678,868,158,670,40,720
Wigan 031,E02001317,8444,7665,779,116,636,27,625
Wigan 032,E02001318,7869,7431,438,85,338,15,421
Wigan 033,E02001319,7356,6744,612,138,462,12,505
Wigan 034,E02001320,7663,6939,724,143,548,33,548
Wigan 035,E02001321,8398,7888,510,87,394,29,484
Wigan 036,E02001322,7448,6970,478,74,390,14,434
Wigan 037,E02001323,7535,6854,681,97,559,25,544
Wigan 038,E02001324,8473,7726,747,210,499,38,496
Wigan 039,E02001325,7775,7197,578,100,451,27,452
Wigan 040,E02001326,7702,7125,577,107,441,29,460
Burnley 001,E02005176,8832,8122,710,142,537,31,609
Burnley 002,E02005177,5797,5176,621,112,478,31,524
Burnley 003,E02005178,8945,7978,967,376,498,93,669
Burnley 004,E02005179,8907,7851,1056,366,672,18,641
Burnley 005,E02005180,7006,6486,520,76,430,14,468
Burnley 006,E02005181,6181,5385,796,207,572,17,562
Burnley 007,E02005182,5875,5147,728,149,566,13,541
Burnley 008,E02005183,6086,5661,425,87,330,8,398
Burnley 009,E02005184,5024,4765,259,46,196,17,305
Burnley 010,E02005185,8408,7212,1196,318,851,27,697
Burnley 011,E02005186,6037,5551,486,102,370,14,480
Burnley 014,E02006881,9961,9057,904,224,644,36,735
Chorley 001,E02005189,5300,4720,580,133,417,30,410
Chorley 002,E02005190,6234,5764,470,79,376,15,420
Chorley 003,E02005191,8320,7731,589,62,503,24,529
Chorley 004,E02005192,7347,6546,801,96,664,41,475
Chorley 005,E02005193,8487,7934,553,88,434,31,539
Chorley 006,E02005194,8139,7242,897,166,690,41,711
Chorley 007,E02005195,7720,6682,1038,120,887,31,862
Chorley 008,E02005196,7438,6439,999,116,861,22,567
Chorley 009,E02005197,6823,6095,728,116,582,30,582
Chorley 010,E02005198,8181,7058,1123,203,861,59,762
Chorley 011,E02005199,7149,6663,486,123,336,27,387
Chorley 012,E02005200,8597,7688,909,133,762,14,673
Chorley 013,E02005201,7959,7354,605,160,419,26,406
Chorley 014,E02005202,9461,8675,786,236,522,28,522
Fylde 001,E02005203,7158,6526,632,64,533,35,812
Fylde 002,E02005204,10318,9271,1047,371,611,65,602
Fylde 003,E02005205,6859,6089,770,54,700,16,561
Fylde 004,E02005206,6816,6125,691,82,582,27,615
Fylde 005,E02005207,8057,7112,945,99,803,43,642
Fylde 006,E02005208,9955,8349,1606,365,1177,64,939
Fylde 007,E02005209,7816,7089,727,198,486,43,581
Fylde 008,E02005210,10232,9140,1092,169,860,63,823
Fylde 009,E02005211,8546,7284,1262,260,920,82,717
Hyndburn 001,E02005212,10800,9753,1047,409,605,33,636
Hyndburn 002,E02005213,11714,10580,1134,265,825,44,840
Hyndburn 003,E02005214,6625,6004,621,229,376,16,446
Hyndburn 004,E02005215,11836,10626,1210,375,798,37,885
Hyndburn 005,E02005216,5398,4782,616,117,472,27,504
Hyndburn 006,E02005217,12126,10874,1252,413,761,78,844
Hyndburn 007,E02005218,7450,6716,734,157,558,19,549
Hyndburn 008,E02005219,8466,7617,849,189,621,39,661
Hyndburn 009,E02005220,6319,5889,430,66,358,6,434
Lancaster 001,E02005221,9955,9096,859,285,537,37,557
Lancaster 002,E02005222,6009,5508,501,94,386,21,406
Lancaster 003,E02005223,7253,6631,622,148,446,28,465
Lancaster 004,E02005224,5190,4666,524,60,445,19,334
Lancaster 005,E02005225,5231,4782,449,39,376,34,347
Lancaster 006,E02005226,7813,6678,1135,218,848,69,766
Lancaster 008,E02005228,5789,5256,533,50,461,22,494
Lancaster 009,E02005229,5631,4677,954,196,685,73,687
Lancaster 010,E02005230,6565,5952,613,99,489,25,613
Lancaster 011,E02005231,8007,7124,883,165,675,43,782
Lancaster 013,E02005233,6069,5127,942,85,811,46,783
Lancaster 014,E02005234,7546,4674,2872,395,2242,235,1681
Lancaster 015,E02005235,5367,3327,2040,263,1659,118,1294
Lancaster 016,E02005236,12755,11645,1110,261,812,37,757
Lancaster 017,E02005237,9839,8145,1694,194,1386,114,1096
Lancaster 018,E02005238,5739,4947,792,89,677,26,564
Lancaster 019,E02005239,11690,7211,4479,312,3183,984,3111
Lancaster 020,E02006871,11927,11034,893,161,692,40,813
Pendle 001,E02005240,5445,4915,530,116,394,20,384
Pendle 002,E02005241,5551,4924,627,193,394,40,409
Pendle 003,E02005242,6183,5556,627,187,411,29,395
Pendle 004,E02005243,5089,4485,604,145,446,13,460
Pendle 005,E02005244,5827,5166,661,121,529,11,465
Pendle 006,E02005245,6945,6352,593,143,420,30,447
Pendle 007,E02005246,5180,4552,628,143,465,20,429
Pendle 008,E02005247,9944,9047,897,268,599,30,631
Pendle 009,E02005248,6489,5866,623,158,363,102,482
Pendle 010,E02005249,9452,8179,1273,345,780,148,828
Pendle 011,E02005250,7702,7082,620,154,362,104,538
Pendle 012,E02005251,6916,6368,548,69,444,35,520
Pendle 013,E02005252,8729,8062,667,183,415,69,658
Preston 001,E02005253,5886,5462,424,89,313,22,423
Preston 002,E02005254,6372,5994,378,32,315,31,406
Preston 003,E02005255,8865,8258,607,56,522,29,598
Preston 004,E02005256,7058,6403,655,94,517,44,639
Preston 005,E02005257,5951,5362,589,105,471,13,432
Preston 006,E02005258,8070,7286,784,58,665,61,658
Preston 007,E02005259,10244,9412,832,129,655,48,764
Preston 008,E02005260,6837,6338,499,26,440,33,478
Preston 009,E02005261,10003,9124,879,232,614,33,718
Preston 010,E02005262,6197,5464,733,88,597,48,603
Preston 011,E02005263,7093,5627,1466,128,1234,104,1122
Preston 012,E02005264,12533,8578,3955,709,2944,302,2527
Preston 013,E02005265,10850,9700,1150,189,908,53,961
Preston 014,E02005266,8187,6686,1501,221,1186,94,1125
Preston 015,E02005267,6892,4287,2605,179,2162,264,1586
Preston 016,E02005268,9270,8261,1009,212,701,96,818
Preston 017,E02005269,9894,7273,2621,440,1892,289,1681
Ribble Valley 001,E02005270,7400,6699,701,124,461,116,510
Ribble Valley 002,E02005271,7540,6825,715,180,499,36,556
Ribble Valley 003,E02005272,7225,6565,660,204,440,16,517
Ribble Valley 004,E02005273,5751,5213,538,156,350,32,421
Ribble Valley 005,E02005274,6627,6009,618,146,449,23,459
Ribble Valley 006,E02005275,5392,4815,577,191,375,11,402
Ribble Valley 007,E02005276,8261,7582,679,181,470,28,507
Ribble Valley 008,E02005277,8936,8263,673,143,517,13,485
Rossendale 001,E02005278,7711,7125,586,153,408,25,532
Rossendale 002,E02005279,10264,9191,1073,344,677,52,766
Rossendale 003,E02005280,10107,8957,1150,428,686,36,673
Rossendale 004,E02005281,8251,7446,805,166,614,25,667
Rossendale 007,E02005284,5805,5317,488,76,407,5,352
Rossendale 008,E02005285,6263,5745,518,76,413,29,486
Rossendale 009,E02005286,7500,6722,778,275,478,25,420
Rossendale 010,E02006884,12081,10996,1085,374,688,23,763
South Ribble 001,E02005287,5354,5081,273,38,217,18,289
South Ribble 002,E02005288,6054,5676,378,48,307,23,343
South Ribble 003,E02005289,6176,5759,417,42,344,31,434
South Ribble 004,E02005290,7210,6651,559,73,450,36,514
South Ribble 005,E02005291,5700,5258,442,39,378,25,451
South Ribble 006,E02005292,5817,5254,563,55,484,24,473
South Ribble 007,E02005293,5593,5030,563,58,473,32,430
South Ribble 008,E02005294,6331,5692,639,90,517,32,563
South Ribble 009,E02005295,7432,6866,566,80,453,33,447
South Ribble 010,E02005296,5790,5368,422,55,343,24,394
South Ribble 011,E02005297,8206,7723,483,140,323,20,476
South Ribble 012,E02005298,7177,6652,525,58,451,16,567
South Ribble 013,E02005299,7211,6372,839,127,685,27,623
South Ribble 014,E02005300,5228,4819,409,57,329,23,371
South Ribble 015,E02005301,6438,5935,503,66,409,28,512
South Ribble 016,E02005302,6971,6262,709,93,587,29,634
South Ribble 017,E02005303,6369,5786,583,72,499,12,476
West Lancashire 001,E02005304,8583,8055,528,177,314,37,420
West Lancashire 002,E02005305,7305,6664,641,114,491,36,425
West Lancashire 003,E02005306,7048,6604,444,55,360,29,391
West Lancashire 004,E02005307,9182,8597,585,198,364,23,449
West Lancashire 005,E02005308,6670,6233,437,77,351,9,410
West Lancashire 006,E02005309,8381,7637,744,102,614,28,485
West Lancashire 007,E02005310,7961,5611,2350,674,1607,69,980
West Lancashire 008,E02005311,5576,5006,570,43,492,35,383
West Lancashire 009,E02005312,5927,5516,411,84,292,35,423
West Lancashire 010,E02005313,8794,8012,782,205,497,80,634
West Lancashire 011,E02005314,6458,5863,595,157,399,39,401
West Lancashire 012,E02005315,8068,7536,532,76,423,33,436
West Lancashire 013,E02005316,6266,5670,596,150,404,42,479
West Lancashire 014,E02005317,7090,6353,737,252,424,61,512
West Lancashire 015,E02005318,7376,6926,450,103,328,19,420
Wyre 001,E02005319,8340,7203,1137,404,618,115,615
Wyre 002,E02005320,5906,5534,372,39,322,11,326
Wyre 003,E02005321,6381,5767,614,107,323,184,407
Wyre 004,E02005322,9921,9096,825,268,528,29,454
Wyre 005,E02005323,6863,6329,534,79,435,20,501
Wyre 006,E02005324,6117,5506,611,78,502,31,481
Wyre 007,E02005325,8968,8208,760,214,514,32,478
Wyre 008,E02005326,8559,7802,757,143,583,31,575
Wyre 009,E02005327,5874,5512,362,54,297,11,321
Wyre 010,E02005328,7484,6942,542,57,456,29,489
Wyre 011,E02005329,8757,8096,661,106,522,33,584
Wyre 012,E02005330,8881,8276,605,79,490,36,496
Wyre 013,E02005331,7627,6949,678,106,547,25,537
Wyre 014,E02005332,8071,7535,536,54,460,22,476
Knowsley 001,E02001327,7451,6897,554,135,414,5,450
Knowsley 002,E02001328,10145,9502,643,136,488,19,552
Knowsley 003,E02001329,7603,6987,616,121,472,23,557
Knowsley 004,E02001330,8706,8055,651,120,502,29,615
Knowsley 005,E02001331,10062,9402,660,161,482,17,611
Knowsley 006,E02001332,6644,6100,544,150,384,10,371
Knowsley 007,E02001333,8200,7457,743,143,576,24,491
Knowsley 008,E02001334,5780,5343,437,106,320,11,370
Knowsley 009,E02001335,7668,7241,427,61,349,17,540
Knowsley 010,E02001336,6833,6273,560,151,392,17,472
Knowsley 011,E02001337,5933,5491,442,69,362,11,307
Knowsley 012,E02001338,5935,5550,385,33,331,21,377
Knowsley 013,E02001339,6739,6348,391,82,295,14,403
Knowsley 014,E02001340,8997,8575,422,51,347,24,480
Knowsley 015,E02001341,6857,6420,437,107,323,7,406
Knowsley 016,E02001342,7172,6856,316,42,257,17,409
Knowsley 017,E02001343,7118,6773,345,32,294,19,383
Knowsley 018,E02001344,5343,5009,334,56,270,8,315
Knowsley 019,E02001345,5637,5397,240,37,181,22,284
Knowsley 020,E02001346,7070,6531,539,186,341,12,481
Liverpool 001,E02001347,7653,7073,580,72,481,27,474
Liverpool 002,E02001348,7222,6566,656,143,483,30,493
Liverpool 003,E02001349,7966,7279,687,89,576,22,600
Liverpool 004,E02001350,7856,7186,670,135,482,53,588
Liverpool 005,E02001351,8894,7867,1027,122,868,37,1026
Liverpool 006,E02001352,7416,6152,1264,116,1079,69,870
Liverpool 007,E02001353,7572,7068,504,110,350,44,441
Liverpool 008,E02001354,7613,7073,540,44,487,9,453
Liverpool 009,E02001355,6664,6000,664,78,562,24,639
Liverpool 010,E02001356,5584,5077,507,72,419,16,366
Liverpool 011,E02001357,6982,6471,511,36,449,26,465
Liverpool 012,E02001358,7069,6162,907,165,715,27,801
Liverpool 013,E02001359,5751,5372,379,29,319,31,325
Liverpool 014,E02001360,8358,7419,939,154,747,38,789
Liverpool 015,E02001361,7618,6981,637,70,555,12,583
Liverpool 016,E02001362,7401,6999,402,25,364,13,456
Liverpool 017,E02001363,7788,6938,850,108,722,20,677
Liverpool 018,E02001364,5311,4663,648,99,513,36,669
Liverpool 019,E02001365,9049,7557,1492,213,1207,72,1271
Liverpool 020,E02001366,8985,7947,1038,143,837,58,856
Liverpool 021,E02001367,9304,8677,627,69,509,49,545
Liverpool 022,E02001368,5847,5295,552,81,432,39,387
Liverpool 023,E02001369,7655,6571,1084,98,889,97,648
Liverpool 024,E02001370,6186,5404,782,60,670,52,553
Liverpool 025,E02001371,7447,6843,604,102,478,24,537
Liverpool 026,E02001372,6221,5696,525,59,437,29,442
Liverpool 027,E02001373,9253,8105,1148,166,918,64,827
Liverpool 028,E02001374,8199,6465,1734,163,1390,181,1415
Liverpool 029,E02001375,7195,6650,545,83,444,18,479
Liverpool 030,E02001376,8469,6646,1823,286,1313,224,1293
Liverpool 031,E02001377,11467,5896,5571,685,3559,1327,2907
Liverpool 032,E02001378,7972,7061,911,89,786,36,641
Liverpool 034,E02001380,7526,7081,445,44,392,9,491
Liverpool 035,E02001381,9286,7039,2247,327,1774,146,1626
Liverpool 036,E02001382,7098,6692,406,14,369,23,423
Liverpool 037,E02001383,7501,5001,2500,172,2013,315,1489
Liverpool 038,E02001384,10762,5861,4901,944,3789,168,2688
Liverpool 039,E02001385,8157,6630,1527,273,1045,209,1090
Liverpool 040,E02001386,7545,6948,597,138,450,9,382
Liverpool 041,E02001387,8025,7141,884,81,751,52,754
Liverpool 042,E02001388,8860,5700,3160,285,2635,240,2086
Liverpool 043,E02001389,6232,4555,1677,140,1403,134,1259
Liverpool 044,E02001390,8756,7731,1025,142,813,70,736
Liverpool 045,E02001391,5970,5611,359,81,267,11,320
Liverpool 046,E02001392,5717,5268,449,37,392,20,448
Liverpool 047,E02001393,7753,6797,956,43,816,97,1011
Liverpool 048,E02001394,10143,6776,3367,221,2970,176,3127
Liverpool 049,E02001395,6056,5495,561,42,491,28,479
Liverpool 050,E02001396,8035,6669,1366,143,1146,77,898
Liverpool 051,E02001397,7631,6910,721,89,612,20,584
Liverpool 052,E02001398,7758,6114,1644,101,1424,119,1149
Liverpool 053,E02001399,7276,6722,554,21,506,27,599
Liverpool 054,E02001400,6614,6089,525,49,452,24,476
Liverpool 055,E02001401,7872,7119,753,51,635,67,557
Liverpool 056,E02001402,8384,7317,1067,117,889,61,708
Liverpool 057,E02001403,6035,5208,827,113,644,70,448
Liverpool 058,E02001404,7260,6628,632,72,513,47,554
Liverpool 059,E02001405,9609,8657,952,313,576,63,650
Liverpool 060,E02006932,9949,3465,6484,841,4699,944,3548
Liverpool 061,E02006933,5436,3512,1924,118,1553,253,1037
Liverpool 062,E02006934,5202,2558,2644,166,2191,287,1256
Sefton 001,E02001429,6751,6355,396,57,324,15,358
Sefton 002,E02001430,7142,6696,446,51,372,23,432
Sefton 003,E02001431,7288,6458,830,81,692,57,586
Sefton 004,E02001432,8398,6832,1566,296,1104,166,1056
Sefton 005,E02001433,7642,6984,658,100,530,28,543
Sefton 006,E02001434,7210,6570,640,67,544,29,619
Sefton 007,E02001435,8058,6988,1070,155,822,93,761
Sefton 008,E02001436,8704,7956,748,91,626,31,739
Sefton 009,E02001437,9586,8693,893,114,727,52,688
Sefton 010,E02001438,7500,6986,514,69,416,29,513
Sefton 011,E02001439,6291,5866,425,50,350,25,362
Sefton 012,E02001440,5811,5530,281,36,228,17,319
Sefton 013,E02001441,6564,6214,350,45,282,23,366
Sefton 014,E02001442,5887,5460,427,39,364,24,350
Sefton 015,E02001443,5664,5329,335,33,282,20,332
Sefton 016,E02001444,5730,5399,331,34,277,20,350
Sefton 017,E02001445,7021,6678,343,52,276,15,417
Sefton 018,E02001446,6837,6489,348,34,294,20,314
Sefton 019,E02001447,5964,5600,364,26,312,26,284
Sefton 020,E02001448,6930,6551,379,55,304,20,343
Sefton 021,E02001449,9241,8707,534,46,455,33,482
Sefton 022,E02001450,8187,7573,614,107,479,28,553
Sefton 023,E02001451,6205,5815,390,57,326,7,362
Sefton 024,E02001452,6623,6114,509,98,408,3,423
Sefton 025,E02001453,8676,8266,410,47,347,16,443
Sefton 026,E02001454,7371,6761,610,52,527,31,477
Sefton 027,E02001455,7197,6865,332,33,289,10,365
Sefton 028,E02001456,7521,6855,666,67,571,28,591
Sefton 029,E02001457,6771,6295,476,63,409,4,402
Sefton 030,E02001458,7668,6988,680,132,538,10,633
Sefton 031,E02001459,7267,6840,427,58,358,11,514
Sefton 032,E02001460,7528,6747,781,84,658,39,601
Sefton 033,E02001461,6326,5965,361,85,263,13,491
Sefton 034,E02001462,7529,6701,828,74,725,29,573
Sefton 035,E02001463,6850,6378,472,71,394,7,539
Sefton 036,E02001464,6867,6060,807,162,626,19,750
Sefton 037,E02001465,6395,5665,730,142,556,32,604
Sefton 038,E02001466,8590,7812,778,149,609,20,710
St. Helens 001,E02001406,7779,7341,438,141,289,8,332
St. Helens 002,E02001407,6179,5839,340,73,254,13,313
St. Helens 003,E02001408,5753,5452,301,71,221,9,272
St. Helens 004,E02001409,9815,9217,598,160,422,16,510
St. Helens 005,E02001410,5837,5418,419,72,336,11,335
St. Helens 006,E02001411,5871,5444,427,56,354,17,361
St. Helens 007,E02001412,8823,8172,651,123,501,27,492
St. Helens 008,E02001413,9682,9122,560,144,391,25,544
St. Helens 009,E02001414,5355,5077,278,33,230,15,299
St. Helens 010,E02001415,6592,5990,602,88,493,21,506
St. Helens 011,E02001416,5926,5354,572,128,419,25,393
St. Helens 012,E02001417,7187,6269,918,171,729,18,690
St. Helens 013,E02001418,5235,4678,557,81,462,14,463
St. Helens 014,E02001419,6818,5935,883,125,737,21,700
St. Helens 015,E02001420,10206,9251,955,213,716,26,818
St. Helens 016,E02001421,10509,9599,910,138,746,26,744
St. Helens 017,E02001422,6362,5821,541,97,432,12,377
St. Helens 018,E02001423,6324,5903,421,38,370,13,311
St. Helens 019,E02001424,13529,12152,1377,325,1018,34,936
St. Helens 020,E02001425,10460,9824,636,147,466,23,554
St. Helens 021,E02001426,5400,5053,347,53,275,19,348
St. Helens 022,E02001427,10213,9356,857,210,604,43,645
St. Helens 023,E02001428,5453,5164,289,31,232,26,280
Wirral 001,E02001467,7547,6735,812,119,657,36,675
Wirral 002,E02001468,7841,7079,762,100,632,30,687
Wirral 003,E02001469,7829,7275,554,86,438,30,513
Wirral 004,E02001470,8593,7974,619,102,491,26,596
Wirral 005,E02001471,7525,6703,822,154,617,51,689
Wirral 006,E02001472,7064,6512,552,68,471,13,496
Wirral 007,E02001473,7660,6986,674,113,549,12,612
Wirral 008,E02001474,7100,6264,836,177,637,22,656
Wirral 009,E02001475,6168,5697,471,91,362,18,535
Wirral 010,E02001476,7626,6706,920,149,748,23,754
Wirral 011,E02001477,7510,6818,692,154,526,12,515
Wirral 012,E02001478,7909,7332,577,103,452,22,526
Wirral 013,E02001479,6173,5798,375,50,299,26,424
Wirral 014,E02001480,7738,6951,787,152,586,49,511
Wirral 015,E02001481,8109,7442,667,89,534,44,519
Wirral 016,E02001482,7723,6687,1036,188,815,33,822
Wirral 017,E02001483,7396,7031,365,39,290,36,524
Wirral 018,E02001484,7663,7126,537,76,434,27,520
Wirral 019,E02001485,6382,5947,435,40,373,22,395
Wirral 020,E02001486,8248,7290,958,81,821,56,668
Wirral 021,E02001487,9284,8006,1278,301,911,66,918
Wirral 022,E02001488,8480,7624,856,115,704,37,723
Wirral 023,E02001489,8293,7831,462,76,352,34,443
Wirral 024,E02001490,8743,8241,502,65,413,24,486
Wirral 025,E02001491,6833,6141,692,168,506,18,483
Wirral 026,E02001492,7846,7046,800,167,567,66,552
Wirral 027,E02001493,7970,6974,996,203,761,32,772
Wirral 028,E02001494,7113,6649,464,88,338,38,500
Wirral 029,E02001495,7789,7185,604,77,508,19,574
Wirral 030,E02001496,6026,5661,365,45,290,30,367
Wirral 031,E02001497,7971,7154,817,129,657,31,685
Wirral 032,E02001498,7568,7101,467,63,374,30,449
Wirral 033,E02001499,6691,6274,417,78,320,19,379
Wirral 034,E02001500,7485,7026,459,42,398,19,482
Wirral 035,E02001501,7971,7469,502,44,434,24,408
Wirral 036,E02001502,8342,7629,713,81,594,38,581
Wirral 037,E02001503,7518,6919,599,103,464,32,473
Wirral 038,E02001504,7329,6844,485,77,368,40,409
Wirral 039,E02001505,6428,6005,423,78,327,18,381
Wirral 040,E02001506,8980,8414,566,101,398,67,553
Wirral 041,E02001507,7296,6946,350,52,276,22,304
Wirral 042,E02001508,8023,7490,533,108,400,25,436
East Riding of Yorkshire 001,E02002684,9688,8937,751,124,591,36,615
East Riding of Yorkshire 002,E02002685,8071,7369,702,101,583,18,546
East Riding of Yorkshire 003,E02002686,7904,7010,894,215,661,18,579
East Riding of Yorkshire 004,E02002687,6032,5167,865,135,708,22,679
East Riding of Yorkshire 005,E02002688,5662,4804,858,148,683,27,684
East Riding of Yorkshire 006,E02002689,5891,5392,499,90,384,25,463
East Riding of Yorkshire 008,E02002691,8074,7400,674,124,517,33,565
East Riding of Yorkshire 009,E02002692,8805,8043,762,147,561,54,589
East Riding of Yorkshire 010,E02002693,6842,6226,616,158,425,33,510
East Riding of Yorkshire 011,E02002694,10943,9864,1079,389,626,64,697
East Riding of Yorkshire 012,E02002695,8099,7271,828,333,462,33,450
East Riding of Yorkshire 013,E02002696,6008,5353,655,85,521,49,565
East Riding of Yorkshire 014,E02002697,7593,7034,559,109,433,17,515
East Riding of Yorkshire 015,E02002698,7586,6800,786,308,417,61,416
East Riding of Yorkshire 016,E02002699,9442,8735,707,134,519,54,642
East Riding of Yorkshire 017,E02002700,6308,5630,678,128,532,18,459
East Riding of Yorkshire 018,E02002701,8541,7884,657,148,491,18,607
East Riding of Yorkshire 019,E02002702,9796,8420,1376,249,1040,87,918
East Riding of Yorkshire 020,E02002703,9198,8261,937,115,774,48,684
East Riding of Yorkshire 021,E02002704,7241,6752,489,125,351,13,420
East Riding of Yorkshire 022,E02002705,6330,5919,411,30,366,15,1163
East Riding of Yorkshire 023,E02002706,6907,6341,566,47,485,34,718
East Riding of Yorkshire 024,E02002707,7617,6800,817,85,692,40,676
East Riding of Yorkshire 025,E02002708,7120,5423,1697,100,1541,56,571
East Riding of Yorkshire 026,E02002709,7534,6951,583,138,425,20,443
East Riding of Yorkshire 027,E02002710,7550,6943,607,89,478,40,541
East Riding of Yorkshire 028,E02002711,7584,6974,610,106,456,48,477
East Riding of Yorkshire 029,E02002712,7511,6870,641,182,445,14,442
East Riding of Yorkshire 031,E02002714,7707,7156,551,113,421,17,550
East Riding of Yorkshire 032,E02002715,12472,10978,1494,523,902,69,715
East Riding of Yorkshire 033,E02002716,8570,7919,651,148,490,13,520
East Riding of Yorkshire 034,E02002717,7606,6872,734,114,585,35,619
East Riding of Yorkshire 035,E02002718,7844,7220,624,149,444,31,502
East Riding of Yorkshire 036,E02002719,5925,5398,527,48,437,42,358
East Riding of Yorkshire 037,E02002720,6994,6337,657,120,519,18,457
East Riding of Yorkshire 038,E02002721,6379,5790,589,113,454,22,428
East Riding of Yorkshire 039,E02002722,8744,7847,897,419,441,37,573
East Riding of Yorkshire 040,E02002723,8439,7396,1043,290,657,96,698
East Riding of Yorkshire 041,E02002724,8789,7685,1104,386,641,77,707
East Riding of Yorkshire 042,E02002725,6599,6057,542,160,354,28,408
East Riding of Yorkshire 043,E02006814,8283,7680,603,57,522,24,534
East Riding of Yorkshire 044,E02006891,7477,6776,701,150,527,24,560
East Riding of Yorkshire 045,E02006892,6474,5700,774,187,564,23,488
Kingston upon Hull 001,E02002652,10846,9495,1351,269,1022,60,819
Kingston upon Hull 002,E02002653,8323,7525,798,167,616,15,588
Kingston upon Hull 003,E02002654,7640,6942,698,125,540,33,544
Kingston upon Hull 004,E02002655,8926,7969,957,209,731,17,759
Kingston upon Hull 005,E02002656,5361,4937,424,63,346,15,358
Kingston upon Hull 006,E02002657,7537,6971,566,55,500,11,437
Kingston upon Hull 007,E02002658,6881,6251,630,78,537,15,559
Kingston upon Hull 008,E02002659,11018,9965,1053,179,805,69,861
Kingston upon Hull 009,E02002660,6942,6338,604,89,511,4,511
Kingston upon Hull 010,E02002661,7963,7244,719,66,633,20,587
Kingston upon Hull 011,E02002662,7215,6477,738,211,506,21,551
Kingston upon Hull 012,E02002663,6850,4341,2509,302,1710,497,1513
Kingston upon Hull 013,E02002664,7614,7193,421,50,352,19,412
Kingston upon Hull 014,E02002665,8312,7482,830,62,698,70,696
Kingston upon Hull 015,E02002666,8961,5113,3848,587,2732,529,2207
Kingston upon Hull 016,E02002667,7110,6339,771,87,651,33,793
Kingston upon Hull 017,E02002668,8864,8084,780,115,640,25,681
Kingston upon Hull 018,E02002669,8486,6039,2447,254,1866,327,1807
Kingston upon Hull 019,E02002670,7871,7198,673,59,593,21,577
Kingston upon Hull 020,E02002671,8365,7263,1102,74,998,30,916
Kingston upon Hull 021,E02002672,7373,6699,674,148,517,9,603
Kingston upon Hull 022,E02002673,7916,6930,986,151,784,51,787
Kingston upon Hull 023,E02002674,6905,6227,678,94,566,18,630
Kingston upon Hull 024,E02002675,8464,6575,1889,293,1413,183,1231
Kingston upon Hull 025,E02002676,7581,6425,1156,172,910,74,1117
Kingston upon Hull 026,E02002677,8420,6977,1443,170,1197,76,1114
Kingston upon Hull 027,E02002678,7692,6716,976,110,781,85,918
Kingston upon Hull 028,E02002679,7415,6855,560,41,511,8,577
Kingston upon Hull 029,E02002680,8871,6524,2347,273,1868,206,1461
Kingston upon Hull 030,E02002681,8511,6716,1795,430,1145,220,1180
Kingston upon Hull 031,E02002682,7953,7025,928,231,669,28,934
Kingston upon Hull 033,E02006813,8220,7616,604,64,525,15,655
North East Lincolnshire 001,E02002726,10273,9195,1078,601,450,27,580
North East Lincolnshire 002,E02002727,5894,4898,996,159,822,15,801
North East Lincolnshire 003,E02002728,7754,6504,1250,317,881,52,1010
North East Lincolnshire 004,E02002729,5946,5427,519,80,431,8,469
North East Lincolnshire 005,E02002730,7599,6326,1273,292,957,24,1021
North East Lincolnshire 006,E02002731,5941,4910,1031,173,827,31,875
North East Lincolnshire 007,E02002732,7588,6917,671,144,490,37,511
North East Lincolnshire 008,E02002733,6052,5255,797,97,677,23,620
North East Lincolnshire 009,E02002734,5146,4562,584,128,442,14,449
North East Lincolnshire 010,E02002735,5354,4707,647,103,532,12,586
North East Lincolnshire 011,E02002736,5872,4862,1010,244,710,56,830
North East Lincolnshire 012,E02002737,7426,6698,728,80,637,11,686
North East Lincolnshire 013,E02002738,7161,6557,604,104,484,16,627
North East Lincolnshire 014,E02002739,5974,5165,809,100,683,26,575
North East Lincolnshire 015,E02002740,5604,5013,591,66,512,13,509
North East Lincolnshire 016,E02002741,9200,7953,1247,148,1012,87,1077
North East Lincolnshire 017,E02002742,5693,5153,540,71,436,33,409
North East Lincolnshire 018,E02002743,5460,5080,380,45,324,11,359
North East Lincolnshire 019,E02002744,7124,6288,836,251,577,8,596
North East Lincolnshire 020,E02002745,7621,7039,582,90,461,31,408
North East Lincolnshire 021,E02002746,8832,8005,827,125,676,26,539
North East Lincolnshire 022,E02002747,7999,7415,584,92,463,29,451
North East Lincolnshire 023,E02002748,8103,7462,641,120,487,34,536
North Lincolnshire 001,E02002749,11066,9820,1246,540,682,24,495
North Lincolnshire 002,E02002750,6282,5745,537,174,343,20,427
North Lincolnshire 003,E02002751,6451,5867,584,178,379,27,379
North Lincolnshire 004,E02002752,6801,6234,567,165,385,17,478
North Lincolnshire 005,E02002753,8691,7980,711,124,542,45,700
North Lincolnshire 006,E02002754,8288,7563,725,228,469,28,452
North Lincolnshire 007,E02002755,7038,6016,1022,186,725,111,812
North Lincolnshire 008,E02002756,8522,7060,1462,348,882,232,921
North Lincolnshire 009,E02002757,6188,5571,617,72,472,73,591
North Lincolnshire 010,E02002758,6349,5667,682,109,523,50,652
North Lincolnshire 011,E02002759,9610,8574,1036,250,739,47,626
North Lincolnshire 012,E02002760,5876,5331,545,50,465,30,530
North Lincolnshire 013,E02002761,6793,6135,658,207,414,37,465
North Lincolnshire 014,E02002762,6707,6093,614,65,518,31,543
North Lincolnshire 015,E02002763,7379,6315,1064,167,863,34,607
North Lincolnshire 016,E02002764,5820,5126,694,98,569,27,554
North Lincolnshire 017,E02002765,6373,5697,676,86,560,30,499
North Lincolnshire 018,E02002766,9160,8349,811,126,646,39,734
North Lincolnshire 019,E02002767,6788,6308,480,72,393,15,406
North Lincolnshire 020,E02002768,7247,6651,596,221,341,34,458
North Lincolnshire 021,E02002769,5841,5387,454,98,333,23,391
North Lincolnshire 022,E02002770,7014,6282,732,187,515,30,470
North Lincolnshire 023,E02002771,7162,6651,511,139,352,20,360
York 001,E02002772,6923,6227,696,96,507,93,663
York 002,E02002773,5756,5347,409,57,339,13,355
York 003,E02002774,6282,5847,435,66,337,32,398
York 004,E02002775,5653,5192,461,71,364,26,366
York 005,E02002776,6455,5784,671,92,560,19,441
York 006,E02002777,8274,7471,803,76,670,57,803
York 007,E02002778,8280,7265,1015,80,844,91,898
York 008,E02002779,9588,8410,1178,102,937,139,1042
York 009,E02002780,8387,6583,1804,182,1435,187,1271
York 010,E02002781,9885,6812,3073,440,2380,253,1864
York 011,E02002782,6345,5629,716,82,593,41,512
York 012,E02002783,10164,9206,958,131,773,54,742
York 013,E02002784,10622,6880,3742,353,2872,517,2005
York 014,E02002785,6872,5645,1227,81,1044,102,1031
York 015,E02002786,10668,7120,3548,594,2638,316,2116
York 016,E02002787,9075,7979,1096,105,921,70,798
York 017,E02002788,8921,7249,1672,129,1376,167,1264
York 018,E02002789,8862,7940,922,137,741,44,796
York 019,E02002790,11399,7775,3624,461,2694,469,2339
York 020,E02002791,6540,6030,510,71,404,35,386
York 021,E02002792,7039,5800,1239,170,975,94,879
York 022,E02002793,9165,8321,844,86,707,51,720
York 023,E02002794,8817,4532,4285,251,3066,968,3278
York 024,E02002795,8079,7487,592,123,427,42,494
Craven 001,E02005742,7414,6733,681,254,396,31,350
Craven 002,E02005743,5126,4635,491,117,338,36,333
Craven 003,E02005744,7678,6940,738,285,386,67,480
Craven 004,E02005745,5119,4676,443,78,343,22,315
Craven 005,E02005746,6406,5804,602,107,468,27,491
Craven 006,E02005747,6650,5798,852,238,570,44,519
Craven 007,E02005748,7375,6669,706,109,558,39,493
Craven 008,E02005749,9641,8759,882,257,589,36,562
Hambleton 001,E02005750,7838,7107,731,262,415,54,464
Hambleton 002,E02005751,8582,8002,580,137,380,63,499
Hambleton 003,E02005752,6663,6115,548,64,447,37,500
Hambleton 004,E02005753,13083,11622,1461,513,894,54,902
Hambleton 005,E02005754,7476,6857,619,90,461,68,553
Hambleton 006,E02005755,6329,5618,711,193,480,38,403
Hambleton 007,E02005756,7217,6005,1212,108,971,133,948
Hambleton 008,E02005757,8452,7422,1030,255,708,67,658
Hambleton 009,E02005758,8330,7464,866,127,654,85,759
Hambleton 010,E02005759,8486,7653,833,253,556,24,568
Hambleton 011,E02005760,6684,5823,861,157,655,49,675
Harrogate 001,E02005761,5459,4964,495,112,343,40,347
Harrogate 002,E02005762,6287,5303,984,129,716,139,715
Harrogate 003,E02005763,6518,5764,754,91,596,67,680
Harrogate 004,E02005764,10415,9217,1198,458,617,123,675
Harrogate 005,E02005765,6211,5540,671,132,484,55,450
Harrogate 006,E02005766,6118,5456,662,143,415,104,389
Harrogate 007,E02005767,6732,6105,627,83,498,46,519
Harrogate 008,E02005768,6028,5269,759,65,545,149,1007
Harrogate 009,E02005769,6902,6069,833,211,578,44,503
Harrogate 010,E02005770,9326,8405,921,151,698,72,795
Harrogate 011,E02005771,7363,6539,824,108,622,94,637
Harrogate 012,E02005772,6150,5714,436,37,357,42,504
Harrogate 013,E02005773,8831,7445,1386,144,1098,144,1002
Harrogate 014,E02005774,9370,8352,1018,154,784,80,669
Harrogate 015,E02005775,9287,7201,2086,268,1447,371,1297
Harrogate 016,E02005776,8407,7393,1014,128,618,268,662
Harrogate 017,E02005777,8465,7737,728,60,608,60,741
Harrogate 018,E02005778,6169,5458,711,55,486,170,532
Harrogate 019,E02005779,7581,6230,1351,143,982,226,950
Harrogate 020,E02005780,10603,9422,1181,161,851,169,800
Harrogate 021,E02005781,5647,5165,482,44,384,54,434
Richmondshire 001,E02005782,7578,6859,719,216,456,47,555
Richmondshire 002,E02005783,8413,7511,902,286,568,48,578
Richmondshire 003,E02005784,6229,5431,798,114,597,87,659
Richmondshire 004,E02005785,15280,11168,4112,662,2741,709,2422
Richmondshire 005,E02005786,6115,5442,673,179,424,70,393
Richmondshire 006,E02005787,8350,7403,947,266,622,59,545
Ryedale 001,E02005788,6399,5711,688,237,405,46,393
Ryedale 002,E02005789,10086,9137,949,348,560,41,501
Ryedale 003,E02005790,6904,6102,802,166,504,132,471
Ryedale 004,E02005791,6689,6062,627,127,466,34,547
Ryedale 007,E02005794,9398,8579,819,152,601,66,692
Ryedale 008,E02006870,12275,10929,1346,664,632,50,590
Scarborough 001,E02005795,7044,6229,815,231,526,58,492
Scarborough 002,E02005796,6891,6310,581,171,362,48,438
Scarborough 003,E02005797,6169,5526,643,143,417,83,402
Scarborough 004,E02005798,8525,7796,729,165,498,66,541
Scarborough 005,E02005799,8991,8313,678,100,550,28,662
Scarborough 006,E02005800,8057,6352,1705,380,1180,145,1045
Scarborough 007,E02005801,5625,5160,465,42,391,32,458
Scarborough 008,E02005802,8357,6979,1378,275,1040,63,1048
Scarborough 009,E02005803,9084,7940,1144,111,969,64,935
Scarborough 010,E02005804,8200,6143,2057,342,1529,186,1234
Scarborough 011,E02005805,7084,6433,651,40,572,39,572
Scarborough 012,E02005806,7166,6589,577,138,422,17,455
Scarborough 013,E02005807,6206,5676,530,96,412,22,433
Scarborough 014,E02005808,11394,10128,1266,498,718,50,631
Selby 001,E02005809,7261,6711,550,193,339,18,414
Selby 002,E02005810,8842,8131,711,111,552,48,639
Selby 003,E02005811,9109,8290,819,148,605,66,740
Selby 004,E02005812,9025,8092,933,270,602,61,504
Selby 005,E02005813,10886,9245,1641,592,899,150,831
Selby 006,E02005814,6418,5850,568,61,485,22,445
Selby 007,E02005815,8214,7681,533,97,405,31,498
Selby 008,E02005816,8415,7655,760,168,546,46,543
Selby 009,E02005817,7125,6563,562,106,433,23,450
Selby 010,E02005818,8154,7548,606,179,391,36,470
Barnsley 001,E02001509,6279,5821,458,135,315,8,333
Barnsley 002,E02001510,5878,5445,433,84,334,15,383
Barnsley 003,E02001511,6191,5671,520,118,386,16,404
Barnsley 004,E02001512,7642,7077,565,112,414,39,528
Barnsley 005,E02001513,7803,7261,542,91,425,26,445
Barnsley 006,E02001514,7267,6427,840,308,505,27,302
Barnsley 007,E02001515,9257,8366,891,272,600,19,620
Barnsley 008,E02001516,6098,5535,563,140,411,12,446
Barnsley 009,E02001517,7886,7367,519,65,435,19,462
Barnsley 010,E02001518,10013,9096,917,124,751,42,842
Barnsley 011,E02001519,6749,6115,634,105,503,26,503
Barnsley 012,E02001520,10662,9819,843,122,691,30,637
Barnsley 013,E02001521,11267,9381,1886,354,1384,148,1381
Barnsley 014,E02001522,8687,7978,709,339,367,3,459
Barnsley 015,E02001523,6755,5948,807,69,706,32,568
Barnsley 016,E02001524,5902,5535,367,85,268,14,347
Barnsley 017,E02001525,6010,5167,843,142,652,49,689
Barnsley 018,E02001526,5827,5216,611,85,520,6,365
Barnsley 019,E02001527,5900,5464,436,69,359,8,373
Barnsley 020,E02001528,10286,9391,895,241,631,23,608
Barnsley 021,E02001529,9416,8693,723,217,482,24,625
Barnsley 022,E02001530,6240,5551,689,233,430,26,517
Barnsley 023,E02001531,6424,5801,623,123,484,16,514
Barnsley 024,E02001532,9492,8509,983,321,622,40,451
Barnsley 025,E02001533,7460,6855,605,218,371,16,422
Barnsley 026,E02001534,9135,8088,1047,206,818,23,606
Barnsley 027,E02001535,6114,5614,500,64,412,24,347
Barnsley 028,E02001536,8396,7762,634,144,483,7,470
Barnsley 029,E02001537,8240,7524,716,165,529,22,557
Barnsley 030,E02001538,7945,7318,627,147,457,23,461
Doncaster 001,E02001539,6018,5575,443,154,280,9,301
Doncaster 002,E02001540,11673,10637,1036,451,564,21,593
Doncaster 003,E02001541,11277,10255,1022,395,594,33,580
Doncaster 004,E02001542,7479,6743,736,276,451,9,513
Doncaster 005,E02001543,8485,7729,756,273,475,8,484
Doncaster 006,E02001544,8711,7966,745,157,571,17,547
Doncaster 007,E02001545,8592,7983,609,147,438,24,553
Doncaster 008,E02001546,8615,7031,1584,156,1388,40,908
Doncaster 009,E02001547,10737,9802,935,336,572,27,716
Doncaster 010,E02001548,8009,6876,1133,291,820,22,683
Doncaster 011,E02001549,5969,5461,508,79,412,17,437
Doncaster 012,E02001550,7463,6821,642,118,516,8,458
Doncaster 013,E02001551,6027,5364,663,63,587,13,612
Doncaster 014,E02001552,7686,6842,844,190,606,48,646
Doncaster 015,E02001553,10018,9025,993,156,774,63,847
Doncaster 016,E02001554,6420,6027,393,89,294,10,363
Doncaster 017,E02001555,5578,5056,522,68,437,17,378
Doncaster 018,E02001556,9294,8288,1006,168,773,65,666
Doncaster 019,E02001557,9487,8022,1465,204,1084,177,1237
Doncaster 020,E02001558,6125,5708,417,58,352,7,371
Doncaster 021,E02001559,7742,7117,625,155,440,30,528
Doncaster 022,E02001560,10508,8247,2261,394,1658,209,1806
Doncaster 023,E02001561,6318,5462,856,87,693,76,787
Doncaster 024,E02001562,5905,5388,517,75,427,15,415
Doncaster 025,E02001563,7635,6918,717,91,599,27,561
Doncaster 026,E02001564,7548,7052,496,107,366,23,484
Doncaster 027,E02001565,6822,6101,721,91,588,42,584
Doncaster 028,E02001566,7937,6711,1226,133,1005,88,978
Doncaster 029,E02001567,9155,8321,834,174,624,36,765
Doncaster 030,E02001568,5906,5413,493,133,354,6,387
Doncaster 031,E02001569,9207,8118,1089,373,685,31,641
Doncaster 032,E02001570,7001,6188,813,197,604,12,526
Doncaster 033,E02001571,6086,5558,528,90,430,8,475
Doncaster 034,E02001572,7236,6561,675,248,404,23,513
Doncaster 035,E02001573,7859,7256,603,227,351,25,436
Doncaster 036,E02001574,6268,5769,499,91,388,20,392
Doncaster 037,E02001575,7269,6519,750,290,453,7,459
Doncaster 038,E02001576,5816,5303,513,97,395,21,466
Doncaster 039,E02001577,6521,5985,536,130,397,9,351
Rotherham 001,E02001578,9461,8509,952,222,716,14,545
Rotherham 002,E02001579,9205,8413,792,175,584,33,553
Rotherham 003,E02001580,8261,7751,510,125,370,15,463
Rotherham 004,E02001581,5854,5485,369,78,279,12,335
Rotherham 005,E02001582,7216,6736,480,97,367,16,401
Rotherham 006,E02001583,5665,5197,468,69,389,10,397
Rotherham 007,E02001584,7105,6579,526,92,421,13,357
Rotherham 008,E02001585,6263,5622,641,90,527,24,541
Rotherham 009,E02001586,8129,7438,691,164,498,29,499
Rotherham 010,E02001587,5824,5308,516,119,388,9,346
Rotherham 011,E02001588,7151,6659,492,83,404,5,417
Rotherham 012,E02001589,8173,7516,657,133,503,21,597
Rotherham 013,E02001590,7492,6855,637,114,500,23,593
Rotherham 014,E02001591,8299,7422,877,145,669,63,747
Rotherham 015,E02001592,8899,8240,659,113,528,18,540
Rotherham 016,E02001593,7095,6060,1035,266,680,89,717
Rotherham 017,E02001594,6880,5527,1353,266,897,190,920
Rotherham 018,E02001595,8765,8207,558,166,381,11,503
Rotherham 019,E02001596,8651,8035,616,105,494,17,579
Rotherham 020,E02001597,9528,8604,924,408,491,25,527
Rotherham 021,E02001598,9629,9010,619,75,520,24,590
Rotherham 022,E02001599,6260,5787,473,68,387,18,449
Rotherham 023,E02001600,10777,9871,906,149,648,109,823
Rotherham 024,E02001601,5042,4720,322,45,262,15,300
Rotherham 025,E02001602,8960,8383,577,135,416,26,528
Rotherham 026,E02001603,6583,6009,574,208,352,14,323
Rotherham 027,E02001604,8575,7852,723,142,549,32,523
Rotherham 028,E02001605,7234,6617,617,115,481,21,506
Rotherham 029,E02001606,8010,7328,682,208,442,32,457
Rotherham 030,E02001607,8812,8267,545,114,415,16,514
Rotherham 031,E02001608,6872,6284,588,82,475,31,460
Rotherham 032,E02001609,8368,7847,521,142,366,13,498
Rotherham 033,E02001610,8242,7595,647,190,442,15,427
Sheffield 001,E02001611,7597,6983,614,190,400,24,403
Sheffield 002,E02001612,5858,5472,386,54,317,15,348
Sheffield 003,E02001613,10444,9687,757,182,556,19,690
Sheffield 004,E02001614,11226,10475,751,183,550,18,653
Sheffield 005,E02001615,7519,6951,568,81,477,10,425
Sheffield 006,E02001616,7091,6572,519,103,410,6,399
Sheffield 007,E02001617,5615,5177,438,88,339,11,519
Sheffield 008,E02001618,9675,8868,807,131,638,38,719
Sheffield 009,E02001619,9422,8698,724,116,589,19,675
Sheffield 010,E02001620,6568,5971,597,104,474,19,589
Sheffield 011,E02001621,5471,4908,563,32,516,15,495
Sheffield 012,E02001622,8884,8059,825,114,695,16,664
Sheffield 013,E02001623,8276,7329,947,93,809,45,570
Sheffield 014,E02001624,9679,8746,933,149,724,60,745
Sheffield 015,E02001625,7830,7199,631,78,533,20,699
Sheffield 016,E02001626,5910,5465,445,42,384,19,455
Sheffield 017,E02001627,6070,5297,773,78,653,42,737
Sheffield 018,E02001628,6329,5705,624,160,406,58,379
Sheffield 019,E02001629,6489,5771,718,91,581,46,558
Sheffield 020,E02001630,8681,7614,1067,171,746,150,895
Sheffield 021,E02001631,7778,7190,588,75,498,15,562
Sheffield 022,E02001632,12300,10480,1820,318,1257,245,1451
Sheffield 023,E02001633,7425,6993,432,41,368,23,393
Sheffield 024,E02001634,9214,7798,1416,142,1185,89,1236
Sheffield 025,E02001635,6032,5653,379,55,312,12,306
Sheffield 026,E02001636,9597,7261,2336,145,1555,636,1355
Sheffield 027,E02001637,6925,6024,901,168,629,104,493
Sheffield 028,E02001638,6362,3256,3106,442,2455,209,2064
Sheffield 029,E02001639,6157,4700,1457,134,1222,101,1033
Sheffield 030,E02001640,8302,4245,4057,743,3081,233,2798
Sheffield 032,E02001642,9663,8834,829,136,638,55,594
Sheffield 033,E02001643,6292,5791,501,38,425,38,473
Sheffield 036,E02001646,8525,3939,4586,475,3743,368,3371
Sheffield 037,E02001647,6111,5691,420,36,366,18,298
Sheffield 038,E02001648,8833,4875,3958,98,3551,309,3102
Sheffield 039,E02001649,9428,8429,999,147,796,56,791
Sheffield 040,E02001650,9106,5108,3998,265,3322,411,2202
Sheffield 041,E02001651,8153,7546,607,112,446,49,624
Sheffield 042,E02001652,12330,6457,5873,577,4630,666,3383
Sheffield 043,E02001653,7149,5703,1446,80,1226,140,744
Sheffield 044,E02001654,6404,5961,443,31,397,15,386
Sheffield 045,E02001655,7655,7036,619,68,540,11,446
Sheffield 046,E02001656,7799,5663,2136,206,1826,104,1474
Sheffield 047,E02001657,8985,7869,1116,159,893,64,921
Sheffield 048,E02001658,5380,4833,547,68,457,22,535
Sheffield 049,E02001659,6124,5666,458,43,408,7,395
Sheffield 050,E02001660,9831,8132,1699,169,1401,129,1390
Sheffield 051,E02001661,7849,6762,1087,98,896,93,809
Sheffield 052,E02001662,7644,7086,558,48,503,7,565
Sheffield 053,E02001663,7694,6715,979,124,784,71,872
Sheffield 054,E02001664,6158,5640,518,38,459,21,414
Sheffield 055,E02001665,9476,8767,709,73,573,63,642
Sheffield 056,E02001666,6195,5819,376,36,332,8,357
Sheffield 059,E02001669,7707,6884,823,117,673,33,684
Sheffield 060,E02001670,5952,5306,646,97,534,15,450
Sheffield 061,E02001671,5965,5676,289,19,259,11,408
Sheffield 062,E02001672,6167,5717,450,52,389,9,336
Sheffield 063,E02001673,5597,5270,327,29,287,11,337
Sheffield 064,E02001674,8704,8116,588,87,485,16,559
Sheffield 065,E02001675,9049,8316,733,104,600,29,618
Sheffield 066,E02001676,6030,5687,343,20,304,19,339
Sheffield 068,E02001678,10018,9267,751,114,598,39,644
Sheffield 069,E02001679,6273,5709,564,69,480,15,505
Sheffield 070,E02001680,6127,5483,644,122,509,13,539
Sheffield 071,E02001681,7459,6926,533,32,482,19,487
Sheffield 072,E02006803,8798,8148,650,155,466,29,546
Sheffield 073,E02006843,9256,3195,6061,650,3748,1663,2591
Sheffield 074,E02006844,8734,3702,5032,563,3926,543,2722
Sheffield 075,E02006868,12161,10199,1962,272,1504,186,1362
Sheffield 076,E02006869,11191,10420,771,192,560,19,595
Bradford 001,E02002183,5594,5148,446,91,331,24,362
Bradford 002,E02002184,12945,11517,1428,478,886,64,819
Bradford 003,E02002185,5948,5446,502,118,356,28,350
Bradford 004,E02002186,12643,11370,1273,438,780,55,791
Bradford 005,E02002187,5888,5441,447,65,357,25,440
Bradford 006,E02002188,7726,7120,606,84,490,32,508
Bradford 007,E02002189,6842,6217,625,83,502,40,544
Bradford 008,E02002190,12001,10825,1176,278,788,110,1081
Bradford 009,E02002191,9413,8443,970,174,764,32,724
Bradford 010,E02002192,9239,8437,802,164,601,37,646
Bradford 011,E02002193,6009,5117,892,167,689,36,604
Bradford 012,E02002194,7500,6951,549,77,447,25,518
Bradford 013,E02002195,6393,5884,509,78,399,32,424
Bradford 014,E02002196,6364,5798,566,104,435,27,533
Bradford 015,E02002197,8517,7427,1090,219,816,55,710
Bradford 016,E02002198,8139,7408,731,144,546,41,526
Bradford 017,E02002199,6407,5912,495,59,422,14,571
Bradford 018,E02002200,9216,8271,945,133,779,33,833
Bradford 019,E02002201,12022,10720,1302,182,1070,50,976
Bradford 020,E02002202,7029,5886,1143,114,969,60,908
Bradford 021,E02002203,7655,6884,771,165,597,9,640
Bradford 022,E02002204,11394,10425,969,214,728,27,781
Bradford 023,E02002205,10113,9184,929,320,573,36,615
Bradford 024,E02002206,8721,7970,751,86,647,18,749
Bradford 025,E02002207,7375,6651,724,109,502,113,545
Bradford 026,E02002208,7621,6818,803,89,699,15,613
Bradford 027,E02002209,5908,5100,808,145,637,26,445
Bradford 028,E02002210,7627,6934,693,78,572,43,546
Bradford 029,E02002211,7199,6634,565,54,413,98,515
Bradford 030,E02002212,7294,6612,682,78,543,61,518
Bradford 031,E02002213,6745,6116,629,140,462,27,426
Bradford 032,E02002214,5917,5403,514,50,438,26,473
Bradford 033,E02002215,10515,9664,851,120,600,131,824
Bradford 034,E02002216,9365,8547,818,149,554,115,754
Bradford 035,E02002217,8855,7894,961,193,687,81,798
Bradford 036,E02002218,9354,8441,913,151,738,24,745
Bradford 037,E02002219,7877,7111,766,138,503,125,664
Bradford 038,E02002220,9288,8523,765,128,522,115,746
Bradford 039,E02002221,13576,10983,2593,424,1789,380,1776
Bradford 040,E02002222,8111,7170,941,182,696,63,705
Bradford 041,E02002223,7821,6899,922,126,650,146,829
Bradford 042,E02002224,10589,9681,908,250,513,145,825
Bradford 043,E02002225,8240,7483,757,159,576,22,592
Bradford 044,E02002226,14938,10871,4067,1102,1958,1007,1834
Bradford 045,E02002227,6503,5586,917,148,680,89,815
Bradford 046,E02002228,6795,5839,956,182,730,44,602
Bradford 047,E02002229,8144,7357,787,173,580,34,612
Bradford 048,E02002230,9502,7877,1625,268,1115,242,1246
Bradford 049,E02002231,12757,11528,1229,219,929,81,1031
Bradford 050,E02002232,6458,5529,929,112,732,85,744
Bradford 051,E02002233,9238,8322,916,176,621,119,851
Bradford 052,E02002234,7933,6949,984,368,595,21,763
Bradford 053,E02002235,7083,6280,803,117,609,77,683
Bradford 054,E02002236,6002,5452,550,36,492,22,524
Bradford 055,E02002237,8304,7432,872,91,742,39,661
Bradford 056,E02002238,6122,5509,613,46,536,31,543
Bradford 057,E02002239,9964,8878,1086,223,830,33,752
Bradford 058,E02002240,10686,9842,844,262,562,20,683
Bradford 059,E02002241,11941,10860,1081,251,808,22,938
Bradford 060,E02002242,7751,7131,620,102,505,13,594
Bradford 061,E02002243,9336,8532,804,233,554,17,632
Calderdale 001,E02002244,6011,5590,421,69,326,26,395
Calderdale 002,E02002245,5627,5000,627,143,462,22,487
Calderdale 003,E02002246,9651,8850,801,222,559,20,600
Calderdale 004,E02002247,9374,8404,970,350,562,58,612
Calderdale 005,E02002248,7523,6793,730,188,523,19,548
Calderdale 006,E02002249,5522,4986,536,113,410,13,499
Calderdale 007,E02002250,8410,7604,806,181,577,48,500
Calderdale 008,E02002251,7511,6252,1259,229,931,99,927
Calderdale 009,E02002252,6025,5459,566,63,487,16,397
Calderdale 010,E02002253,7616,6681,935,186,690,59,690
Calderdale 011,E02002254,5763,5288,475,70,387,18,395
Calderdale 012,E02002255,7836,7025,811,207,488,116,687
Calderdale 013,E02002256,9317,8141,1176,424,702,50,724
Calderdale 014,E02002257,6202,5490,712,132,490,90,566
Calderdale 015,E02002258,8816,7892,924,175,722,27,669
Calderdale 016,E02002259,6577,5933,644,47,560,37,614
Calderdale 017,E02002260,9114,7940,1174,263,866,45,746
Calderdale 018,E02002261,8108,7223,885,200,656,29,653
Calderdale 019,E02002262,7914,7079,835,160,644,31,580
Calderdale 020,E02002263,6697,6071,626,69,525,32,540
Calderdale 021,E02002264,6995,6347,648,126,481,41,590
Calderdale 022,E02002265,5432,4856,576,100,455,21,437
Calderdale 023,E02002266,5820,5277,543,67,459,17,433
Calderdale 024,E02002267,8150,7460,690,131,532,27,579
Calderdale 025,E02002268,9888,8632,1256,362,848,46,822
Calderdale 026,E02002269,9569,8625,944,225,690,29,689
Calderdale 027,E02002270,8358,7499,859,174,614,71,638
Kirklees 001,E02002271,7100,6510,590,143,428,19,462
Kirklees 002,E02002272,9445,8418,1027,289,723,15,658
Kirklees 003,E02002273,6174,5638,536,68,452,16,481
Kirklees 004,E02002274,6999,6343,656,86,558,12,460
Kirklees 005,E02002275,8558,7657,901,223,634,44,661
Kirklees 006,E02002276,7281,6670,611,109,478,24,626
Kirklees 007,E02002277,6510,5861,649,94,523,32,423
Kirklees 008,E02002278,6372,5711,661,125,527,9,501
Kirklees 009,E02002279,6174,5479,695,114,558,23,521
Kirklees 010,E02002280,6248,5739,509,78,406,25,431
Kirklees 011,E02002281,11399,10318,1081,225,816,40,739
Kirklees 012,E02002282,7203,6539,664,95,519,50,532
Kirklees 013,E02002283,7833,7304,529,118,361,50,568
Kirklees 014,E02002284,6054,5604,450,61,366,23,341
Kirklees 015,E02002285,7991,7396,595,112,464,19,530
Kirklees 016,E02002286,6076,5491,585,58,504,23,523
Kirklees 017,E02002287,6933,6055,878,103,700,75,702
Kirklees 018,E02002288,9273,8362,911,224,655,32,675
Kirklees 019,E02002289,6560,5934,626,147,413,66,458
Kirklees 020,E02002290,6229,5740,489,95,373,21,397
Kirklees 021,E02002291,6552,6036,516,70,429,17,451
Kirklees 022,E02002292,5708,5291,417,25,374,18,386
Kirklees 023,E02002293,7932,7137,795,201,515,79,489
Kirklees 024,E02002294,10691,9881,810,281,468,61,516
Kirklees 025,E02002295,6692,5919,773,118,613,42,589
Kirklees 026,E02002296,6782,6072,710,108,578,24,448
Kirklees 027,E02002297,6899,6280,619,55,516,48,584
Kirklees 028,E02002298,6748,6202,546,167,358,21,388
Kirklees 029,E02002299,6550,5337,1213,105,954,154,890
Kirklees 030,E02002300,6683,5931,752,71,648,33,431
Kirklees 031,E02002301,7655,6379,1276,211,958,107,804
Kirklees 032,E02002302,6386,5851,535,84,433,18,460
Kirklees 033,E02002303,6469,5724,745,107,595,43,642
Kirklees 034,E02002304,6542,5211,1331,136,1068,127,1057
Kirklees 035,E02002305,6071,5244,827,118,638,71,611
Kirklees 036,E02002306,6363,5842,521,71,416,34,456
Kirklees 037,E02002307,6004,5475,529,67,441,21,405
Kirklees 038,E02002308,6459,5852,607,79,495,33,532
Kirklees 039,E02002309,6767,5638,1129,83,914,132,890
Kirklees 040,E02002310,6083,5252,831,62,675,94,580
Kirklees 041,E02002311,6427,5778,649,121,503,25,521
Kirklees 042,E02002312,8137,5569,2568,389,1877,302,1391
Kirklees 043,E02002313,7663,6559,1104,199,711,194,852
Kirklees 044,E02002314,6009,5477,532,75,433,24,443
Kirklees 045,E02002315,6775,5974,801,104,657,40,677
Kirklees 046,E02002316,6435,6045,390,52,315,23,353
Kirklees 047,E02002317,7042,6373,669,95,529,45,584
Kirklees 048,E02002318,6404,5745,659,79,541,39,509
Kirklees 049,E02002319,6549,5957,592,117,459,16,471
Kirklees 050,E02002320,6398,5744,654,91,523,40,509
Kirklees 051,E02002321,7232,5638,1594,155,1315,124,1495
Kirklees 052,E02002322,6401,5870,531,161,351,19,327
Kirklees 053,E02002323,8443,7698,745,149,577,19,598
Kirklees 054,E02002324,6520,6000,520,106,402,12,347
Kirklees 055,E02002325,8534,7759,775,246,499,30,523
Kirklees 056,E02002326,6264,5841,423,88,312,23,409
Kirklees 057,E02002327,9845,9082,763,186,540,37,580
Kirklees 058,E02002328,6976,6312,664,128,487,49,434
Kirklees 059,E02002329,11956,10939,1017,275,688,54,741
Leeds 001,E02002330,6598,6136,462,75,358,29,451
Leeds 002,E02002331,6592,5388,1204,137,1029,38,598
Leeds 003,E02002332,5849,5458,391,64,308,19,329
Leeds 004,E02002333,7819,7083,736,190,521,25,534
Leeds 005,E02002334,7116,6509,607,156,428,23,495
Leeds 006,E02002335,7552,6956,596,92,466,38,552
Leeds 007,E02002336,6765,6299,466,84,354,28,482
Leeds 008,E02002337,6712,6034,678,62,601,15,514
Leeds 009,E02002338,6800,6080,720,93,597,30,515
Leeds 010,E02002339,5719,5216,503,52,432,19,437
Leeds 011,E02002340,5536,5086,450,67,369,14,436
Leeds 012,E02002341,7348,6694,654,91,500,63,653
Leeds 013,E02002342,5752,5411,341,30,285,26,366
Leeds 014,E02002343,5729,5308,421,39,370,12,442
Leeds 015,E02002344,7678,6898,780,115,625,40,664
Leeds 016,E02002345,5503,5026,477,42,397,38,475
Leeds 017,E02002346,5982,5436,546,46,469,31,476
Leeds 018,E02002347,5998,5412,586,55,505,26,467
Leeds 019,E02002348,6111,5588,523,49,450,24,472
Leeds 020,E02002349,5637,4882,755,56,651,48,724
Leeds 021,E02002350,6201,5418,783,92,663,28,657
Leeds 022,E02002351,5399,5036,363,32,308,23,438
Leeds 023,E02002352,7371,6552,819,51,701,67,750
Leeds 024,E02002353,5817,5311,506,29,450,27,491
Leeds 025,E02002354,7825,7054,771,96,625,50,706
Leeds 027,E02002356,7521,6725,796,112,630,54,734
Leeds 028,E02002357,7784,6852,932,94,796,42,797
Leeds 029,E02002358,7353,6878,475,68,395,12,545
Leeds 030,E02002359,6393,5869,524,71,419,34,414
Leeds 031,E02002360,6748,5867,881,58,782,41,736
Leeds 032,E02002361,5746,5151,595,65,488,42,550
Leeds 033,E02002362,7695,6863,832,81,691,60,747
Leeds 034,E02002363,6976,5783,1193,179,950,64,1041
Leeds 035,E02002364,5768,5338,430,70,335,25,484
Leeds 037,E02002366,7767,6997,770,60,622,88,643
Leeds 038,E02002367,5915,5152,763,63,642,58,717
Leeds 039,E02002368,7952,7169,783,88,678,17,645
Leeds 040,E02002369,6939,6295,644,54,554,36,632
Leeds 041,E02002370,6653,6053,600,97,490,13,517
Leeds 042,E02002371,9614,8323,1291,163,999,129,1230
Leeds 044,E02002373,8559,2739,5820,986,4626,208,3523
Leeds 045,E02002374,6636,5167,1469,96,1260,113,1282
Leeds 046,E02002375,6386,4764,1622,61,1494,67,1287
Leeds 047,E02002376,6869,6002,867,100,723,44,609
Leeds 048,E02002377,7067,6029,1038,177,701,160,913
Leeds 050,E02002379,5243,4581,662,80,563,19,490
Leeds 051,E02002380,5270,4832,438,36,386,16,519
Leeds 052,E02002381,6103,5381,722,72,634,16,692
Leeds 053,E02002382,6001,4833,1168,204,832,132,1174
Leeds 054,E02002383,7636,2671,4965,728,3857,380,3302
Leeds 055,E02002384,10792,6176,4616,316,3386,914,2722
Leeds 056,E02002385,7996,4597,3399,321,2821,257,2625
Leeds 057,E02002386,8343,7685,658,127,512,19,525
Leeds 058,E02002387,5455,4820,635,70,541,24,627
Leeds 059,E02002388,7357,6441,916,119,757,40,814
Leeds 060,E02002389,6600,5822,778,80,665,33,589
Leeds 061,E02002390,6055,5560,495,36,447,12,461
Leeds 062,E02002391,7772,7047,725,92,618,15,641
Leeds 063,E02002392,9275,2902,6373,453,5108,812,3880
Leeds 064,E02002393,7589,6012,1577,190,1183,204,1237
Leeds 065,E02002394,6773,5652,1121,131,925,65,1058
Leeds 066,E02002395,6340,5849,491,31,435,25,506
Leeds 067,E02002396,8466,7377,1089,98,927,64,1076
Leeds 068,E02002397,7430,6753,677,98,553,26,563
Leeds 069,E02002398,7443,6903,540,95,422,23,485
Leeds 070,E02002399,6204,5613,591,97,471,23,583
Leeds 071,E02002400,8222,6622,1600,191,1319,90,1349
Leeds 072,E02002401,6203,5545,658,149,491,18,584
Leeds 073,E02002402,5774,5392,382,53,311,18,397
Leeds 074,E02002403,6071,5464,607,122,464,21,467
Leeds 075,E02002404,8676,5972,2704,270,2253,181,1845
Leeds 076,E02002405,7484,6791,693,67,591,35,608
Leeds 077,E02002406,7018,6620,398,73,317,8,434
Leeds 078,E02002407,6389,5571,818,101,692,25,610
Leeds 079,E02002408,7237,6504,733,96,621,16,599
Leeds 080,E02002409,5940,5414,526,36,470,20,506
Leeds 081,E02002410,6591,5897,694,68,614,12,531
Leeds 082,E02002411,7054,5183,1871,178,1539,154,1169
Leeds 083,E02002412,6798,6155,643,44,579,20,517
Leeds 085,E02002414,5725,4737,988,95,817,76,803
Leeds 086,E02002415,6483,5224,1259,207,866,186,1161
Leeds 087,E02002416,6319,5849,470,83,375,12,418
Leeds 088,E02002417,6327,5734,593,71,504,18,352
Leeds 089,E02002418,7234,6781,453,80,360,13,434
Leeds 090,E02002419,7832,6902,930,123,766,41,797
Leeds 091,E02002420,7853,6789,1064,164,819,81,804
Leeds 092,E02002421,5931,5308,623,115,476,32,521
Leeds 093,E02002422,6180,5699,481,44,414,23,525
Leeds 094,E02002423,5641,5153,488,64,402,22,465
Leeds 095,E02002424,7612,6994,618,52,536,30,563
Leeds 096,E02002425,8448,7812,636,116,498,22,571
Leeds 097,E02002426,7661,7052,609,127,467,15,518
Leeds 098,E02002427,6854,6313,541,69,463,9,498
Leeds 099,E02002428,6878,6102,776,87,653,36,553
Leeds 100,E02002429,8245,7570,675,63,588,24,643
Leeds 101,E02002430,7175,6489,686,148,513,25,566
Leeds 102,E02002431,7992,7107,885,155,700,30,804
Leeds 103,E02002432,7200,6728,472,91,369,12,393
Leeds 104,E02002433,6177,5380,797,93,683,21,647
Leeds 105,E02002434,8621,7637,984,126,839,19,643
Leeds 106,E02002435,7394,6627,767,112,623,32,632
Leeds 107,E02002436,6605,6066,539,124,406,9,444
Leeds 108,E02002437,6190,5795,395,44,326,25,330
Leeds 109,E02006852,12417,8002,4415,275,3927,213,3110
Leeds 110,E02006861,12512,4370,8142,1326,6211,605,5288
Leeds 111,E02006875,7484,3220,4264,382,3184,698,2420
Leeds 112,E02006876,7145,4909,2236,123,1892,221,1530
Wakefield 001,E02002438,7871,7280,591,162,415,14,494
Wakefield 002,E02002439,7639,6872,767,178,551,38,608
Wakefield 003,E02002440,7751,7262,489,66,404,19,490
Wakefield 004,E02002441,8626,7783,843,107,709,27,544
Wakefield 005,E02002442,6713,6105,608,103,467,38,581
Wakefield 006,E02002443,5943,5406,537,62,458,17,428
Wakefield 007,E02002444,5881,5344,537,61,457,19,484
Wakefield 008,E02002445,7004,6481,523,51,448,24,413
Wakefield 009,E02002446,6038,5633,405,75,320,10,362
Wakefield 010,E02002447,6146,5533,613,135,465,13,418
Wakefield 011,E02002448,7564,6939,625,172,442,11,508
Wakefield 012,E02002449,8138,7498,640,102,515,23,568
Wakefield 013,E02002450,6757,6212,545,109,407,29,461
Wakefield 014,E02002451,7186,6777,409,71,324,14,403
Wakefield 015,E02002452,7963,7068,895,195,668,32,616
Wakefield 016,E02002453,9248,8280,968,248,652,68,662
Wakefield 017,E02002454,7553,6247,1306,209,830,267,983
Wakefield 018,E02002455,6149,5550,599,115,472,12,382
Wakefield 019,E02002456,7166,6347,819,85,641,93,735
Wakefield 020,E02002457,7603,6838,765,136,523,106,619
Wakefield 021,E02002458,8809,8023,786,164,597,25,597
Wakefield 022,E02002459,9349,8588,761,105,593,63,726
Wakefield 023,E02002460,7055,6629,426,74,326,26,450
Wakefield 024,E02002461,10059,9197,862,124,697,41,565
Wakefield 025,E02002462,7307,6677,630,108,495,27,582
Wakefield 026,E02002463,9104,8239,865,202,625,38,599
Wakefield 027,E02002464,7848,7238,610,200,392,18,498
Wakefield 028,E02002465,5988,5404,584,38,489,57,532
Wakefield 029,E02002466,8986,8271,715,104,598,13,530
Wakefield 030,E02002467,8234,7027,1207,237,816,154,868
Wakefield 031,E02002468,6046,5568,478,68,379,31,392
Wakefield 032,E02002469,5945,5588,357,106,241,10,292
Wakefield 033,E02002470,6144,5715,429,90,319,20,415
Wakefield 034,E02002471,10404,9582,822,185,587,50,622
Wakefield 035,E02002472,5963,5354,609,74,520,15,390
Wakefield 036,E02002473,6336,5872,464,70,386,8,419
Wakefield 037,E02002474,6115,5617,498,75,403,20,396
Wakefield 038,E02002475,5975,5454,521,33,456,32,408
Wakefield 039,E02002476,5845,5358,487,140,335,12,413
Wakefield 040,E02002477,6321,5847,474,154,315,5,354
Wakefield 041,E02002478,5832,5430,402,131,248,23,361
Wakefield 042,E02002479,8334,7661,673,238,424,11,410
Wakefield 043,E02002480,5872,5342,530,128,354,48,424
Wakefield 044,E02002481,6325,5843,482,123,334,25,394
Wakefield 045,E02002482,6702,6103,599,176,402,21,438
Derby 001,E02002796,6135,5573,562,70,451,41,435
Derby 002,E02002797,7487,6893,594,82,452,60,551
Derby 003,E02002798,10138,9287,851,163,651,37,788
Derby 004,E02002799,5992,5473,519,46,459,14,503
Derby 005,E02002800,7131,6015,1116,114,944,58,821
Derby 006,E02002801,7611,7071,540,77,451,12,521
Derby 007,E02002802,8012,7163,849,169,642,38,742
Derby 008,E02002803,7766,4888,2878,355,2382,141,1970
Derby 009,E02002804,7633,6929,704,127,550,27,531
Derby 010,E02002805,5701,5307,394,79,304,11,338
Derby 011,E02002806,6547,4443,2104,301,1704,99,1403
Derby 012,E02002807,9021,8378,643,106,509,28,564
Derby 013,E02002808,11819,7830,3989,721,3009,259,2318
Derby 014,E02002809,6676,6062,614,70,534,10,473
Derby 015,E02002810,8220,7486,734,65,634,35,607
Derby 016,E02002811,9971,8136,1835,248,1363,224,1462
Derby 017,E02002812,6965,6128,837,68,720,49,791
Derby 018,E02002813,10322,8565,1757,328,1223,206,1353
Derby 019,E02002814,7360,6781,579,88,451,40,536
Derby 020,E02002815,7664,6678,986,118,743,125,831
Derby 021,E02002816,9406,8576,830,113,641,76,845
Derby 022,E02002817,6317,5780,537,32,477,28,468
Derby 023,E02002818,7665,6727,938,95,793,50,729
Derby 024,E02002819,7408,6233,1175,115,1007,53,767
Derby 025,E02002820,9708,8638,1070,164,865,41,954
Derby 026,E02002821,11010,9578,1432,335,1040,57,1131
Derby 027,E02002822,6738,6167,571,63,475,33,528
Derby 028,E02002823,7475,6952,523,65,442,16,528
Derby 029,E02002824,9656,8715,941,197,706,38,792
Derby 030,E02002825,8544,7672,872,145,681,46,633
Derby 031,E02002826,6654,6170,484,61,404,19,472
Leicester 001,E02002827,6431,5823,608,80,503,25,590
Leicester 002,E02002828,7582,6998,584,20,521,43,575
Leicester 003,E02002829,10609,9498,1111,205,807,99,824
Leicester 004,E02002830,10049,8768,1281,176,1015,90,1054
Leicester 005,E02002831,6832,6311,521,64,408,49,460
Leicester 006,E02002832,8072,7299,773,122,552,99,740
Leicester 007,E02002833,8160,7356,804,166,528,110,638
Leicester 008,E02002834,9731,8591,1140,89,933,118,902
Leicester 009,E02002835,12628,10786,1842,254,1431,157,929
Leicester 010,E02002836,9331,8525,806,152,494,160,741
Leicester 011,E02002837,7445,6649,796,80,626,90,628
Leicester 012,E02002838,7723,7013,710,71,596,43,721
Leicester 013,E02002839,7638,7032,606,78,494,34,465
Leicester 016,E02002842,7658,6039,1619,187,1212,220,1208
Leicester 017,E02002843,13049,11725,1324,281,779,264,1020
Leicester 018,E02002844,11954,10970,984,178,697,109,922
Leicester 019,E02002845,10350,9298,1052,105,814,133,791
Leicester 020,E02002846,7385,6733,652,75,526,51,626
Leicester 021,E02002847,10274,9416,858,141,567,150,863
Leicester 022,E02002848,11199,9479,1720,227,1213,280,1285
Leicester 023,E02002849,12432,7944,4488,709,3370,409,2587
Leicester 025,E02002851,7984,7349,635,48,535,52,552
Leicester 026,E02002852,7098,6498,600,98,465,37,489
Leicester 027,E02002853,12799,10856,1943,205,1452,286,1532
Leicester 028,E02002854,8224,7313,911,119,732,60,810
Leicester 029,E02002855,6583,5180,1403,150,1051,202,1019
Leicester 030,E02002856,11621,8179,3442,518,2441,483,1957
Leicester 031,E02002857,6230,5228,1002,112,817,73,795
Leicester 032,E02002858,7464,6585,879,68,739,72,738
Leicester 034,E02002860,7944,7230,714,121,568,25,600
Leicester 035,E02002861,7752,7103,649,103,528,18,681
Leicester 036,E02002862,8317,7623,694,120,551,23,586
Leicester 037,E02006815,9184,8413,771,137,598,36,644
Leicester 038,E02006817,8111,6625,1486,99,1062,325,1090
Leicester 039,E02006819,8109,7423,686,75,583,28,625
Leicester 040,E02006850,9855,4107,5748,800,3966,982,3240
Leicester 041,E02006851,6032,2690,3342,261,2608,473,1674
Nottingham 001,E02002868,5773,5425,348,39,293,16,398
Nottingham 002,E02002869,7425,6581,844,127,691,26,730
Nottingham 004,E02002871,7841,7173,668,106,534,28,584
Nottingham 005,E02002872,8732,7835,897,109,762,26,716
Nottingham 006,E02002873,9042,8002,1040,125,852,63,857
Nottingham 007,E02002874,7958,6916,1042,41,924,77,834
Nottingham 008,E02002875,8250,7338,912,81,789,42,846
Nottingham 009,E02002876,7957,7035,922,65,809,48,837
Nottingham 010,E02002877,7527,6485,1042,121,833,88,813
Nottingham 011,E02002878,8983,7933,1050,207,805,38,803
Nottingham 012,E02002879,9107,7590,1517,144,1286,87,1331
Nottingham 013,E02002880,8639,7688,951,100,801,50,793
Nottingham 014,E02002881,6175,5550,625,37,559,29,499
Nottingham 015,E02002882,8201,6268,1933,129,1630,174,1473
Nottingham 016,E02002883,7574,6362,1212,114,1004,94,1030
Nottingham 017,E02002884,6131,4823,1308,89,1016,203,1047
Nottingham 018,E02002885,8149,6272,1877,199,1331,347,1422
Nottingham 019,E02002886,8785,7885,900,99,640,161,678
Nottingham 020,E02002887,6463,5890,573,46,497,30,451
Nottingham 021,E02002888,6554,5700,854,109,679,66,734
Nottingham 022,E02002889,8585,3826,4759,697,3789,273,2641
Nottingham 023,E02002890,11170,6744,4426,479,3404,543,2357
Nottingham 024,E02002891,8332,7659,673,77,551,45,524
Nottingham 025,E02002892,6071,5535,536,37,480,19,488
Nottingham 026,E02002893,13419,6995,6424,845,4512,1067,3691
Nottingham 027,E02002894,6845,6181,664,90,487,87,597
Nottingham 028,E02002895,7995,4015,3980,460,3202,318,2492
Nottingham 029,E02002896,10014,7981,2033,396,1421,216,1289
Nottingham 030,E02002897,7896,7235,661,79,517,65,513
Nottingham 031,E02002898,10920,4899,6021,1118,4217,686,3080
Nottingham 032,E02002899,9952,4334,5618,287,4243,1088,4476
Nottingham 034,E02002901,5735,5202,533,40,483,10,496
Nottingham 035,E02002902,8620,7227,1393,116,1192,85,1136
Nottingham 036,E02002903,6343,5697,646,94,522,30,513
Nottingham 037,E02002904,6137,5595,542,91,425,26,457
Nottingham 038,E02006834,7711,7088,623,62,536,25,616
Nottingham 039,E02006904,7050,4075,2975,240,2375,360,1681
Nottingham 040,E02006905,7619,6091,1528,194,1113,221,879
Rutland 001,E02002863,7812,6546,1266,163,1034,69,1569
Rutland 002,E02002864,5851,5245,606,170,407,29,421
Rutland 003,E02002865,7902,6870,1032,272,667,93,666
Rutland 004,E02002866,7384,6675,709,106,560,43,536
Rutland 005,E02002867,8420,7345,1075,226,734,115,642
Amber Valley 001,E02004029,6459,5843,616,144,433,39,489
Amber Valley 002,E02004030,5630,5185,445,72,368,5,354
Amber Valley 003,E02004031,7474,6592,882,174,689,19,530
Amber Valley 004,E02004032,8261,7609,652,154,476,22,521
Amber Valley 005,E02004033,8824,7951,873,117,739,17,667
Amber Valley 006,E02004034,7326,6803,523,70,428,25,445
Amber Valley 007,E02004035,6475,5993,482,35,422,25,482
Amber Valley 008,E02004036,9919,9095,824,157,640,27,731
Amber Valley 009,E02004037,7670,7085,585,106,454,25,534
Amber Valley 010,E02004038,7797,6865,932,192,714,26,666
Amber Valley 011,E02004039,8044,7345,699,102,580,17,552
Amber Valley 012,E02004040,9016,8234,782,103,657,22,650
Amber Valley 013,E02004041,7029,6443,586,101,465,20,512
Amber Valley 015,E02004043,7025,6448,577,94,466,17,426
Amber Valley 016,E02004044,7717,6918,799,174,537,88,534
Amber Valley 017,E02006827,7643,6914,729,162,560,7,590
Bolsover 001,E02004045,9092,8408,684,200,454,30,530
Bolsover 002,E02004046,6221,5720,501,102,392,7,412
Bolsover 003,E02004047,5651,5051,600,225,364,11,371
Bolsover 004,E02004048,6687,6030,657,179,468,10,390
Bolsover 005,E02004049,7781,7251,530,121,398,11,387
Bolsover 006,E02004050,7045,6535,510,165,322,23,383
Bolsover 007,E02004051,9016,7971,1045,321,633,91,684
Bolsover 008,E02004052,7868,7242,626,164,453,9,438
Bolsover 009,E02004053,7877,7161,716,242,457,17,458
Bolsover 010,E02004054,8628,7897,731,182,512,37,581
Chesterfield 001,E02004055,7127,6517,610,109,479,22,479
Chesterfield 002,E02004056,7802,7162,640,186,445,9,467
Chesterfield 003,E02004057,7675,6926,749,88,641,20,588
Chesterfield 004,E02004058,7814,7141,673,130,523,20,519
Chesterfield 005,E02004059,7261,6701,560,60,477,23,537
Chesterfield 006,E02004060,7632,7050,582,139,429,14,451
Chesterfield 007,E02004061,7186,6541,645,69,559,17,528
Chesterfield 008,E02004062,7992,7421,571,66,487,18,557
Chesterfield 009,E02004063,7973,7348,625,103,489,33,597
Chesterfield 010,E02004064,8748,7337,1411,177,1158,76,994
Chesterfield 011,E02004065,8437,7876,561,112,428,21,520
Chesterfield 012,E02004066,11731,10591,1140,253,843,44,948
Chesterfield 013,E02004067,6410,5723,687,207,459,21,463
Derbyshire Dales 001,E02004068,7566,6967,599,181,384,34,402
Derbyshire Dales 002,E02004069,6762,6094,668,137,485,46,553
Derbyshire Dales 003,E02004070,6385,5803,582,142,420,20,455
Derbyshire Dales 004,E02004071,5118,4651,467,109,339,19,370
Derbyshire Dales 005,E02004072,8558,7837,721,155,547,19,545
Derbyshire Dales 006,E02004073,9050,8234,816,202,576,38,641
Derbyshire Dales 007,E02004074,5813,5348,465,170,277,18,310
Derbyshire Dales 008,E02004075,7447,6775,672,125,504,43,495
Derbyshire Dales 009,E02004076,6582,5797,785,284,464,37,365
Derbyshire Dales 010,E02004077,7835,6976,859,136,679,44,630
Erewash 001,E02004078,7148,6359,789,240,543,6,492
Erewash 003,E02004080,9395,8259,1136,266,834,36,701
Erewash 004,E02004081,5716,5262,454,55,387,12,428
Erewash 005,E02004082,6304,5867,437,71,358,8,404
Erewash 006,E02004083,7760,7171,589,128,437,24,503
Erewash 007,E02004084,6216,5815,401,107,289,5,309
Erewash 008,E02004085,8688,7898,790,110,660,20,649
Erewash 009,E02004086,7335,6793,542,111,410,21,449
Erewash 010,E02004087,7818,7045,773,107,642,24,645
Erewash 011,E02004088,7614,6981,633,51,536,46,580
Erewash 012,E02004089,6705,5749,956,154,765,37,708
Erewash 013,E02004090,6140,5577,563,83,462,18,392
Erewash 014,E02004091,8889,8097,792,81,669,42,764
Erewash 015,E02004092,9556,8662,894,131,739,24,687
Erewash 016,E02006828,6797,6301,496,66,418,12,482
High Peak 001,E02004093,6408,5867,541,126,404,11,503
High Peak 002,E02004094,7325,6668,657,151,499,7,369
High Peak 003,E02004095,9866,8771,1095,341,706,48,718
High Peak 004,E02004096,9491,8871,620,97,481,42,648
High Peak 005,E02004097,7678,7032,646,156,453,37,534
High Peak 006,E02004098,7317,6724,593,144,421,28,410
High Peak 008,E02004100,7610,6937,673,180,460,33,469
High Peak 010,E02004102,8540,6981,1559,457,1033,69,780
High Peak 011,E02004103,7072,6393,679,168,491,20,508
High Peak 012,E02004104,7074,6484,590,133,431,26,447
High Peak 013,E02006872,12511,11656,855,320,502,33,737
North East Derbyshire 001,E02004105,9445,8783,662,236,412,14,425
North East Derbyshire 002,E02004106,6986,6591,395,44,339,12,394
North East Derbyshire 004,E02004108,7538,6884,654,136,477,41,410
North East Derbyshire 005,E02004109,6742,6309,433,49,368,16,321
North East Derbyshire 006,E02004110,7464,6966,498,96,378,24,402
North East Derbyshire 007,E02004111,5477,5069,408,22,372,14,263
North East Derbyshire 008,E02004112,6525,6066,459,80,355,24,389
North East Derbyshire 009,E02004113,9191,8341,850,234,595,21,533
North East Derbyshire 010,E02004114,7283,6804,479,58,401,20,443
North East Derbyshire 011,E02004115,9020,8356,664,126,518,20,568
North East Derbyshire 012,E02004116,7887,7112,775,243,509,23,370
North East Derbyshire 013,E02004117,7312,6771,541,128,393,20,402
North East Derbyshire 014,E02006804,8153,7553,600,156,431,13,470
South Derbyshire 001,E02004118,6815,6136,679,47,595,37,568
South Derbyshire 002,E02004119,10860,9632,1228,325,851,52,729
South Derbyshire 003,E02004120,7252,6686,566,50,483,33,519
South Derbyshire 004,E02004121,6666,6151,515,107,390,18,485
South Derbyshire 005,E02004122,6544,5843,701,94,539,68,502
South Derbyshire 006,E02004123,6383,5758,625,175,414,36,442
South Derbyshire 007,E02004124,7614,7060,554,96,451,7,526
South Derbyshire 008,E02004125,8988,8203,785,182,578,25,637
South Derbyshire 009,E02004126,6900,6176,724,76,620,28,533
South Derbyshire 011,E02004128,10255,9377,878,206,642,30,693
South Derbyshire 012,E02006919,8529,7318,1211,198,994,19,617
South Derbyshire 013,E02006920,7805,7065,740,139,585,16,726
Blaby 002,E02005334,5640,5229,411,52,345,14,441
Blaby 003,E02005335,6891,6372,519,86,407,26,472
Blaby 004,E02005336,7106,6278,828,141,637,50,693
Blaby 005,E02005337,9744,8955,789,149,575,65,696
Blaby 006,E02005338,9853,9007,846,145,674,27,725
Blaby 007,E02005339,8448,7866,582,115,450,17,576
Blaby 008,E02005340,8844,7856,988,133,833,22,639
Blaby 009,E02005341,6913,6365,548,95,436,17,481
Blaby 010,E02005342,6725,6294,431,78,343,10,367
Blaby 011,E02005343,6647,6250,397,96,293,8,365
Blaby 012,E02005344,7461,6906,555,121,415,19,330
Blaby 013,E02006820,9643,9024,619,129,453,37,539
Charnwood 001,E02005345,6061,5481,580,76,484,20,513
Charnwood 002,E02005346,11278,9274,2004,394,1416,194,1513
Charnwood 003,E02005347,9882,5307,4575,955,3282,338,2504
Charnwood 004,E02005348,5829,5203,626,54,512,60,561
Charnwood 005,E02005349,6986,6412,574,117,419,38,495
Charnwood 006,E02005350,6519,5911,608,110,479,19,452
Charnwood 007,E02005351,10662,5919,4743,494,3548,701,2793
Charnwood 008,E02005352,6156,5686,470,73,349,48,411
Charnwood 009,E02005353,9433,7973,1460,168,1165,127,1159
Charnwood 010,E02005354,9088,8092,996,83,853,60,958
Charnwood 011,E02005355,6534,5818,716,170,535,11,432
Charnwood 012,E02005356,6493,5841,652,118,501,33,513
Charnwood 013,E02005357,7257,6622,635,191,416,28,540
Charnwood 014,E02005358,10175,9305,870,186,657,27,734
Charnwood 015,E02005359,5884,5495,389,70,302,17,312
Charnwood 016,E02005360,6342,5679,663,60,554,49,570
Charnwood 017,E02005361,6561,6007,554,94,456,4,515
Charnwood 018,E02005362,6243,5693,550,84,447,19,370
Charnwood 019,E02005363,7221,6479,742,83,630,29,397
Charnwood 020,E02005364,5300,4924,376,40,321,15,352
Charnwood 021,E02005365,9668,8813,855,112,704,39,556
Charnwood 022,E02005366,6528,5983,545,113,417,15,468
Harborough 002,E02005368,6201,5731,470,83,364,23,428
Harborough 003,E02005369,9799,8829,970,228,687,55,602
Harborough 004,E02005370,8940,8321,619,195,398,26,439
Harborough 005,E02005371,10045,9231,814,149,619,46,579
Harborough 006,E02005372,9416,8700,716,119,572,25,579
Harborough 007,E02005373,9720,8855,865,154,666,45,754
Harborough 008,E02005374,6532,5728,804,160,515,129,550
Harborough 009,E02005375,8396,7446,950,181,715,54,656
Harborough 010,E02005376,9353,8455,898,380,493,25,508
Harborough 011,E02006816,6980,6464,516,76,423,17,450
Hinckley and Bosworth 001,E02005377,8286,7665,621,142,450,29,451
Hinckley and Bosworth 002,E02005378,5199,4845,354,32,308,14,380
Hinckley and Bosworth 003,E02005379,6065,5541,524,116,385,23,343
Hinckley and Bosworth 004,E02005380,8373,7748,625,147,450,28,528
Hinckley and Bosworth 005,E02005381,8009,7495,514,108,387,19,467
Hinckley and Bosworth 006,E02005382,10047,8919,1128,237,845,46,625
Hinckley and Bosworth 007,E02005383,9022,8291,731,177,527,27,527
Hinckley and Bosworth 008,E02005384,6419,5994,425,53,335,37,442
Hinckley and Bosworth 009,E02005385,5953,5553,400,50,330,20,487
Hinckley and Bosworth 010,E02005386,8375,7255,1120,187,875,58,844
Hinckley and Bosworth 011,E02005387,9072,8112,960,153,776,31,707
Hinckley and Bosworth 012,E02005388,5690,5065,625,66,524,35,548
Hinckley and Bosworth 013,E02005389,5706,5259,447,60,362,25,374
Hinckley and Bosworth 014,E02005390,8862,8227,635,148,455,32,509
Melton 001,E02005391,9616,8675,941,257,644,40,561
Melton 002,E02005392,8906,8059,847,191,604,52,615
Melton 003,E02005393,6996,6363,633,118,492,23,382
Melton 004,E02005394,9383,8198,1185,295,825,65,759
Melton 005,E02005395,8869,7994,875,214,639,22,687
Melton 006,E02005396,6606,6040,566,97,456,13,449
North West Leicestershire 001,E02005397,8283,7554,729,208,466,55,497
North West Leicestershire 002,E02005398,6095,5418,677,150,497,30,440
North West Leicestershire 003,E02005399,6363,5663,700,153,504,43,557
North West Leicestershire 004,E02005400,5637,5290,347,38,302,7,300
North West Leicestershire 005,E02005401,5712,5310,402,45,337,20,368
North West Leicestershire 006,E02005402,6167,5658,509,67,414,28,381
North West Leicestershire 007,E02005403,6867,6409,458,119,330,9,371
North West Leicestershire 008,E02005404,7559,6999,560,103,445,12,466
North West Leicestershire 009,E02005405,6907,6419,488,104,371,13,443
North West Leicestershire 010,E02005406,7393,6501,892,193,661,38,575
North West Leicestershire 011,E02005407,8676,7873,803,133,642,28,627
North West Leicestershire 012,E02005408,7461,6752,709,180,475,54,454
North West Leicestershire 013,E02005409,10348,9561,787,190,582,15,572
Oadby and Wigston 003,E02005412,8178,7533,645,92,508,45,549
Oadby and Wigston 005,E02005414,7774,7114,660,124,526,10,415
Oadby and Wigston 006,E02005415,7490,6747,743,131,594,18,603
Oadby and Wigston 007,E02005416,8802,8362,440,82,340,18,466
Oadby and Wigston 008,E02006818,8255,7736,519,53,420,46,466
Oadby and Wigston 009,E02006911,15671,12884,2787,229,2298,260,2439
Boston 001,E02005417,7296,6616,680,138,510,32,574
Boston 002,E02005418,10021,8423,1598,392,892,314,1096
Boston 003,E02005419,8131,6333,1798,395,999,404,1266
Boston 004,E02005420,8229,7328,901,134,672,95,690
Boston 006,E02005422,6085,5507,578,94,445,39,482
Boston 007,E02005423,9541,8507,1034,262,710,62,717
Boston 008,E02006864,8003,7352,651,73,516,62,557
Boston 009,E02006865,7331,6557,774,81,627,66,604
East Lindsey 001,E02005424,9904,9140,764,195,491,78,580
East Lindsey 002,E02005425,6338,5887,451,75,350,26,391
East Lindsey 003,E02005426,9633,8729,904,315,568,21,684
East Lindsey 004,E02005427,6786,5868,918,252,623,43,524
East Lindsey 005,E02005428,8082,7324,758,200,537,21,541
East Lindsey 006,E02005429,6515,5867,648,147,465,36,472
East Lindsey 007,E02005430,6867,6268,599,58,509,32,459
East Lindsey 008,E02005431,8384,7556,828,237,550,41,482
East Lindsey 009,E02005432,7515,6794,721,95,585,41,572
East Lindsey 010,E02005433,7066,6211,855,208,569,78,583
East Lindsey 011,E02005434,7073,6215,858,292,519,47,382
East Lindsey 012,E02005435,7279,6401,878,149,700,29,676
East Lindsey 013,E02005436,7676,6859,817,253,533,31,472
East Lindsey 014,E02005437,5861,4928,933,269,630,34,703
East Lindsey 015,E02005438,6439,5788,651,104,527,20,480
East Lindsey 016,E02005439,11241,9563,1678,361,1244,73,1197
East Lindsey 017,E02005440,5363,4875,488,102,366,20,407
East Lindsey 018,E02005441,8379,7727,652,93,529,30,537
Lincoln 001,E02005442,5736,5166,570,86,472,12,480
Lincoln 002,E02005443,6811,5897,914,120,748,46,688
Lincoln 003,E02005444,11954,9265,2689,402,2177,110,1837
Lincoln 004,E02005445,11600,9263,2337,396,1772,169,1546
Lincoln 005,E02005446,8473,4275,4198,995,3046,157,2356
Lincoln 006,E02005447,6759,4904,1855,305,1410,140,1348
Lincoln 007,E02005448,7192,6398,794,131,630,33,625
Lincoln 008,E02005449,7918,6066,1852,145,1625,82,1117
Lincoln 009,E02005450,8486,7680,806,102,685,19,673
Lincoln 010,E02005451,7639,6750,889,153,708,28,707
Lincoln 011,E02005452,10973,10143,830,144,646,40,777
North Kesteven 001,E02005453,10568,9715,853,148,641,64,689
North Kesteven 003,E02005455,12280,11074,1206,231,944,31,890
North Kesteven 004,E02005456,9781,8459,1322,143,1118,61,1215
North Kesteven 005,E02005457,8344,7462,882,228,589,65,555
North Kesteven 006,E02005458,6527,5913,614,116,470,28,399
North Kesteven 007,E02005459,8005,7145,860,199,610,51,626
North Kesteven 008,E02005460,6247,5087,1160,146,915,99,1373
North Kesteven 009,E02005461,6261,5691,570,50,482,38,536
North Kesteven 010,E02005462,9064,7793,1271,372,832,67,901
North Kesteven 011,E02005463,8607,7522,1085,192,832,61,744
North Kesteven 012,E02005464,8198,7484,714,159,532,23,577
North Kesteven 013,E02006866,6473,5667,806,70,714,22,440
North Kesteven 014,E02006867,7411,6856,555,77,449,29,579
South Holland 001,E02005465,8440,7764,676,168,460,48,423
South Holland 002,E02005466,6507,6032,475,49,395,31,441
South Holland 003,E02005467,7110,6428,682,246,389,47,457
South Holland 004,E02005468,7492,6950,542,57,444,41,471
South Holland 005,E02005469,7416,6771,645,68,521,56,584
South Holland 006,E02005470,10379,9054,1325,266,824,235,897
South Holland 007,E02005471,9080,8051,1029,232,631,166,745
South Holland 008,E02005472,9828,8805,1023,332,617,74,538
South Holland 009,E02005473,9263,8140,1123,228,777,118,741
South Holland 010,E02005474,6546,6009,537,63,439,35,355
South Holland 011,E02005475,6209,5717,492,99,374,19,399
South Kesteven 001,E02005476,7239,6650,589,122,430,37,540
South Kesteven 002,E02005477,8844,8141,703,85,577,41,544
South Kesteven 003,E02005478,9908,8921,987,188,734,65,734
South Kesteven 004,E02005479,8277,7327,950,142,759,49,694
South Kesteven 005,E02005480,7332,6451,881,247,596,38,627
South Kesteven 006,E02005481,10963,8951,2012,507,1364,141,1175
South Kesteven 007,E02005482,9774,8813,961,154,750,57,848
South Kesteven 008,E02005483,7829,7082,747,158,556,33,550
South Kesteven 009,E02005484,6952,6276,676,141,512,23,494
South Kesteven 010,E02005485,6055,5502,553,107,423,23,492
South Kesteven 011,E02005486,8401,7281,1120,291,769,60,603
South Kesteven 012,E02005487,9199,8489,710,84,570,56,702
South Kesteven 013,E02005488,6263,5703,560,125,385,50,494
South Kesteven 014,E02005489,7051,6350,701,189,496,16,443
South Kesteven 015,E02005490,9132,8108,1024,269,700,55,612
South Kesteven 016,E02005491,10569,9101,1468,287,1048,133,935
West Lindsey 001,E02005492,9425,8621,804,334,435,35,619
West Lindsey 002,E02005493,9304,8511,793,187,578,28,612
West Lindsey 003,E02005494,9452,8418,1034,352,595,87,600
West Lindsey 004,E02005495,9645,8324,1321,456,838,27,921
West Lindsey 005,E02005496,6456,5891,565,102,424,39,477
West Lindsey 006,E02005497,7031,6128,903,273,606,24,485
West Lindsey 007,E02005498,7152,6653,499,81,387,31,424
West Lindsey 008,E02005499,8068,7420,648,168,450,30,540
West Lindsey 009,E02005500,6795,5967,828,135,654,39,555
West Lindsey 010,E02005501,7358,6715,643,91,507,45,579
West Lindsey 011,E02005502,8564,7831,733,140,556,37,461
Corby 001,E02005612,6676,5995,681,122,511,48,500
Corby 002,E02005613,8833,7984,849,177,619,53,676
Corby 003,E02005614,6706,5793,913,114,740,59,549
Corby 004,E02005615,8507,7836,671,111,512,48,604
Corby 005,E02005616,5299,4735,564,69,435,60,482
Corby 006,E02005617,9738,8551,1187,335,726,126,771
Corby 008,E02006862,6112,5503,609,54,527,28,513
Corby 009,E02006863,9384,7805,1579,328,1108,143,868
Daventry 001,E02005619,5844,5256,588,73,483,32,434
Daventry 002,E02005620,7980,7275,705,121,538,46,568
Daventry 003,E02005621,7958,6865,1093,108,933,52,812
Daventry 004,E02005622,8785,8038,747,155,563,29,628
Daventry 005,E02005623,8025,7239,786,93,654,39,636
Daventry 006,E02005624,9242,8128,1114,233,832,49,733
Daventry 007,E02005625,9122,8090,1032,208,766,58,712
Daventry 008,E02005626,6662,5971,691,166,472,53,651
Daventry 009,E02005627,6711,6085,626,115,471,40,520
Daventry 010,E02005628,7514,6775,739,205,506,28,575
East Northamptonshire 001,E02005629,5703,5159,544,83,403,58,413
East Northamptonshire 002,E02005630,9917,8688,1229,342,664,223,783
East Northamptonshire 003,E02005631,10006,8994,1012,296,610,106,672
East Northamptonshire 004,E02005632,6042,5530,512,66,410,36,425
East Northamptonshire 005,E02005633,8641,7915,726,225,446,55,490
East Northamptonshire 006,E02005634,8535,7703,832,229,553,50,618
East Northamptonshire 007,E02005635,8649,7735,914,182,687,45,612
East Northamptonshire 008,E02005636,11136,10009,1127,156,927,44,812
East Northamptonshire 009,E02005637,8302,7236,1066,174,835,57,898
East Northamptonshire 010,E02005638,9834,9051,783,151,585,47,636
Kettering 001,E02005639,5276,4875,401,42,341,18,411
Kettering 002,E02005640,10697,9537,1160,287,815,58,555
Kettering 003,E02005641,7694,6906,788,226,519,43,484
Kettering 004,E02005642,8266,7468,798,147,608,43,684
Kettering 005,E02005643,8047,7147,900,194,671,35,781
Kettering 006,E02005644,8251,6867,1384,257,991,136,970
Kettering 007,E02005645,10992,9400,1592,253,1226,113,1057
Kettering 008,E02005646,6423,5999,424,55,343,26,467
Kettering 009,E02005647,7032,6329,703,66,612,25,610
Kettering 010,E02005648,7215,6710,505,67,413,25,529
Kettering 011,E02005649,13582,12403,1179,239,895,45,814
Northampton 001,E02005650,6852,5327,1525,92,1203,230,1103
Northampton 002,E02005651,6277,5825,452,49,369,34,426
Northampton 003,E02005652,5965,5452,513,48,410,55,434
Northampton 004,E02005653,8119,7130,989,143,766,80,783
Northampton 005,E02005654,8223,7271,952,94,790,68,716
Northampton 006,E02005655,5811,5392,419,15,360,44,441
Northampton 007,E02005656,5901,5251,650,67,520,63,560
Northampton 008,E02005657,6093,5463,630,59,514,57,483
Northampton 009,E02005658,6286,5177,1109,115,888,106,726
Northampton 010,E02005659,5063,4670,393,35,331,27,392
Northampton 011,E02005660,5660,5128,532,75,411,46,664
Northampton 012,E02005661,6481,5760,721,71,592,58,551
Northampton 013,E02005662,6732,5909,823,48,705,70,766
Northampton 014,E02005663,5448,4950,498,56,409,33,542
Northampton 015,E02005664,6007,4842,1165,75,1020,70,991
Northampton 016,E02005665,7365,6720,645,48,524,73,703
Northampton 017,E02005666,8173,7161,1012,136,776,100,723
Northampton 018,E02005667,6029,5379,650,71,528,51,502
Northampton 019,E02005668,6108,5559,549,34,492,23,352
Northampton 020,E02005669,5693,5230,463,56,371,36,433
Northampton 021,E02005670,8177,6256,1921,205,1403,313,1377
Northampton 022,E02005671,7285,5859,1426,155,1156,115,1219
Northampton 023,E02005672,7327,5327,2000,172,1495,333,1341
Northampton 024,E02005673,7166,5969,1197,117,962,118,895
Northampton 025,E02005674,7051,5407,1644,96,1355,193,1274
Northampton 026,E02005675,5733,5089,644,80,535,29,593
Northampton 027,E02005676,5913,5337,576,59,499,18,479
Northampton 028,E02005677,8053,6763,1290,149,1009,132,987
Northampton 029,E02005678,9717,8596,1121,98,968,55,867
Northampton 030,E02005679,8828,7915,913,112,745,56,825
Northampton 031,E02005680,8533,7802,731,153,533,45,660
South Northamptonshire 001,E02005681,8128,7542,586,114,441,31,483
South Northamptonshire 002,E02005682,6358,5863,495,72,391,32,430
South Northamptonshire 003,E02005683,13255,11917,1338,279,974,85,997
South Northamptonshire 004,E02005684,7984,7286,698,106,564,28,605
South Northamptonshire 005,E02005685,8066,7190,876,228,592,56,676
South Northamptonshire 006,E02005686,7461,6875,586,98,459,29,482
South Northamptonshire 007,E02005687,5920,5333,587,101,439,47,462
South Northamptonshire 008,E02005688,8671,7894,777,170,568,39,628
South Northamptonshire 009,E02005689,7641,7048,593,158,414,21,538
South Northamptonshire 010,E02005690,5377,4699,678,154,465,59,445
South Northamptonshire 011,E02005691,6328,5694,634,61,412,161,423
Wellingborough 001,E02005692,6572,5987,585,114,444,27,451
Wellingborough 002,E02005693,8272,7478,794,133,605,56,684
Wellingborough 003,E02005694,7647,7080,567,85,446,36,569
Wellingborough 004,E02005695,7321,6043,1278,310,802,166,942
Wellingborough 005,E02005696,5818,5281,537,77,430,30,454
Wellingborough 006,E02005697,6047,5189,858,106,679,73,714
Wellingborough 007,E02005698,5743,5262,481,49,393,39,436
Wellingborough 008,E02005699,8239,7308,931,132,760,39,765
Wellingborough 009,E02005700,8865,8133,732,188,515,29,548
Wellingborough 010,E02005701,10832,9849,983,255,675,53,663
Ashfield 001,E02005819,6146,5661,485,119,349,17,477
Ashfield 002,E02005820,5728,5338,390,56,329,5,341
Ashfield 003,E02005821,6388,5781,607,113,485,9,506
Ashfield 004,E02005822,9531,8430,1101,242,808,51,788
Ashfield 005,E02005823,7518,6753,765,141,610,14,579
Ashfield 006,E02005824,9727,8968,759,105,621,33,614
Ashfield 007,E02005825,8012,7343,669,103,537,29,594
Ashfield 008,E02005826,6072,5427,645,136,499,10,450
Ashfield 009,E02005827,8303,7569,734,82,626,26,469
Ashfield 010,E02005828,7109,6576,533,116,382,35,390
Ashfield 011,E02005829,6753,6265,488,79,394,15,411
Ashfield 012,E02005830,6111,5713,398,100,282,16,327
Ashfield 013,E02005831,8570,7581,989,131,836,22,612
Ashfield 014,E02005832,8924,7845,1079,213,842,24,773
Ashfield 015,E02005833,7427,6927,500,87,402,11,417
Ashfield 016,E02005834,7178,6623,555,87,445,23,489
Bassetlaw 001,E02005835,10180,9360,820,321,482,17,543
Bassetlaw 002,E02005836,8933,8345,588,123,434,31,516
Bassetlaw 003,E02005837,7809,6744,1065,90,945,30,702
Bassetlaw 004,E02005838,8095,7560,535,227,299,9,383
Bassetlaw 005,E02005839,6162,5593,569,124,425,20,405
Bassetlaw 006,E02005840,9050,8286,764,164,563,37,551
Bassetlaw 008,E02005842,8622,7832,790,181,571,38,672
Bassetlaw 009,E02005843,6403,5764,639,88,518,33,567
Bassetlaw 010,E02005844,7566,6720,846,239,588,19,550
Bassetlaw 012,E02005846,6491,5707,784,154,570,60,660
Bassetlaw 013,E02005847,6634,5972,662,86,512,64,545
Bassetlaw 014,E02005848,6799,6232,567,59,463,45,537
Bassetlaw 015,E02005849,9055,8311,744,199,497,48,518
Bassetlaw 016,E02006903,11064,10164,900,199,665,36,704
Broxtowe 001,E02005850,6892,6363,529,93,422,14,412
Broxtowe 002,E02005851,5927,5401,526,124,397,5,416
Broxtowe 003,E02005852,7930,7399,531,112,405,14,451
Broxtowe 004,E02005853,8976,8370,606,156,429,21,557
Broxtowe 007,E02005856,7270,6738,532,58,445,29,509
Broxtowe 008,E02005857,6238,5694,544,69,455,20,430
Broxtowe 009,E02005858,7450,6313,1137,98,848,191,1110
Broxtowe 010,E02005859,9003,8198,805,154,630,21,633
Broxtowe 011,E02005860,8339,6463,1876,248,1309,319,1358
Broxtowe 012,E02005861,5516,4782,734,73,603,58,509
Broxtowe 013,E02005862,7823,6925,898,92,712,94,735
Broxtowe 014,E02005863,7369,6708,661,61,571,29,608
Broxtowe 015,E02005864,8238,7536,702,131,531,40,634
Broxtowe 016,E02006906,12516,11720,796,134,622,40,772
Gedling 001,E02005865,7929,7271,658,86,546,26,438
Gedling 002,E02005866,8948,8262,686,199,467,20,471
Gedling 004,E02005868,6451,5983,468,53,393,22,345
Gedling 005,E02005869,5837,5403,434,38,384,12,471
Gedling 006,E02005870,6593,5845,748,81,626,41,590
Gedling 007,E02005871,7132,6600,532,51,460,21,571
Gedling 008,E02005872,5777,5313,464,92,359,13,355
Gedling 009,E02005873,10034,9251,783,81,682,20,674
Gedling 010,E02005874,8384,7664,720,78,604,38,668
Gedling 011,E02005875,7209,6746,463,59,392,12,499
Gedling 012,E02005876,9055,8336,719,97,592,30,623
Gedling 013,E02005877,7365,6684,681,57,602,22,650
Gedling 014,E02005878,9548,8690,858,94,735,29,759
Gedling 015,E02005879,7398,6446,952,179,755,18,697
Gedling 016,E02006835,5883,5384,499,57,422,20,399
Mansfield 001,E02005880,6237,5756,481,99,377,5,362
Mansfield 002,E02005881,5762,5223,539,150,377,12,396
Mansfield 003,E02005882,7891,7352,539,101,417,21,477
Mansfield 004,E02005883,7718,6855,863,118,713,32,627
Mansfield 005,E02005884,6124,5599,525,61,436,28,549
Mansfield 006,E02005885,8282,7612,670,139,504,27,661
Mansfield 007,E02005886,10348,9567,781,161,596,24,709
Mansfield 008,E02005887,9110,7646,1464,333,963,168,1087
Mansfield 009,E02005888,8171,7032,1139,220,841,78,922
Mansfield 010,E02005889,10174,9371,803,99,658,46,726
Mansfield 011,E02005890,6703,6227,476,57,397,22,432
Mansfield 012,E02005891,6323,5608,715,113,581,21,523
Mansfield 013,E02005892,11623,10465,1158,249,851,58,854
Newark and Sherwood 001,E02005893,10023,9104,919,427,466,26,503
Newark and Sherwood 002,E02005894,9853,8919,934,271,619,44,538
Newark and Sherwood 003,E02005895,7986,7438,548,108,415,25,467
Newark and Sherwood 004,E02005896,7342,6755,587,126,433,28,453
Newark and Sherwood 005,E02005897,8926,8060,866,200,637,29,534
Newark and Sherwood 006,E02005898,10772,9929,843,297,524,22,599
Newark and Sherwood 007,E02005899,10647,9024,1623,504,949,170,927
Newark and Sherwood 008,E02005900,7297,6434,863,247,588,28,546
Newark and Sherwood 009,E02005901,8872,7850,1022,164,775,83,852
Newark and Sherwood 010,E02005902,8181,7438,743,115,593,35,543
Newark and Sherwood 011,E02005903,9757,8900,857,294,536,27,635
Newark and Sherwood 012,E02005904,8283,7433,850,130,693,27,668
Newark and Sherwood 013,E02005905,6878,6181,697,85,582,30,581
Rushcliffe 001,E02005906,7035,6277,758,107,628,23,552
Rushcliffe 002,E02005907,9131,8294,837,255,552,30,509
Rushcliffe 003,E02005908,8878,8132,746,162,555,29,521
Rushcliffe 004,E02005909,8192,7212,980,112,828,40,837
Rushcliffe 005,E02005910,8991,6767,2224,388,1738,98,1375
Rushcliffe 006,E02005911,8573,7759,814,93,671,50,808
Rushcliffe 007,E02005912,8846,7961,885,121,708,56,786
Rushcliffe 008,E02005913,6828,6259,569,55,482,32,461
Rushcliffe 009,E02005914,7203,6644,559,167,367,25,384
Rushcliffe 010,E02005915,5705,5298,407,74,314,19,386
Rushcliffe 011,E02005916,7216,6439,777,175,577,25,484
Rushcliffe 012,E02005917,5741,5378,363,42,296,25,360
Rushcliffe 013,E02005918,5096,4759,337,78,248,11,295
Rushcliffe 014,E02005919,6379,5481,898,111,677,110,632
Rushcliffe 015,E02005920,7315,6734,581,107,434,40,498
Herefordshire 001,E02002905,6043,5498,545,98,424,23,455
Herefordshire 002,E02002906,5775,5167,608,117,476,15,473
Herefordshire 003,E02002907,5916,5254,662,176,439,47,432
Herefordshire 004,E02002908,8557,7710,847,166,613,68,590
Herefordshire 005,E02002909,10349,9390,959,319,594,46,543
Herefordshire 006,E02002910,7875,7077,798,217,550,31,390
Herefordshire 007,E02002911,9323,8320,1003,176,733,94,841
Herefordshire 008,E02002912,7144,6408,736,89,539,108,594
Herefordshire 009,E02002913,5600,4974,626,78,484,64,541
Herefordshire 010,E02002914,8929,7955,974,156,752,66,867
Herefordshire 011,E02002915,6715,5940,775,86,633,56,629
Herefordshire 012,E02002916,9663,8036,1627,288,1215,124,1115
Herefordshire 013,E02002917,6900,5928,972,127,757,88,821
Herefordshire 014,E02002918,5963,5514,449,47,364,38,469
Herefordshire 015,E02002919,9312,8065,1247,144,985,118,888
Herefordshire 016,E02002920,6524,5825,699,111,540,48,650
Herefordshire 017,E02002921,7757,6852,905,190,685,30,762
Herefordshire 018,E02002922,6247,5658,589,79,473,37,479
Herefordshire 019,E02002923,9636,8640,996,393,527,76,561
Herefordshire 020,E02002924,6073,5543,530,98,393,39,395
Herefordshire 021,E02002925,10952,9831,1121,191,830,100,885
Herefordshire 022,E02002926,10582,9482,1100,435,598,67,629
Herefordshire 023,E02002927,11642,10564,1078,196,785,97,832
Shropshire 025,E02006008,7498,6715,783,160,595,28,437
Shropshire 027,E02006009,7124,5910,1214,167,971,76,1436
Shropshire 029,E02006010,11150,9916,1234,378,794,62,659
Shropshire 031,E02006011,5941,5411,530,72,435,23,399
Shropshire 033,E02006012,6138,5474,664,166,481,17,493
Shropshire 034,E02006013,7743,7093,650,77,537,36,598
Shropshire 035,E02006014,9211,8427,784,166,583,35,559
Shropshire 001,E02006015,9871,8793,1078,447,560,71,452
Shropshire 002,E02006016,7503,6871,632,77,518,37,554
Shropshire 004,E02006017,7463,6730,733,193,434,106,421
Shropshire 005,E02006018,11773,10543,1230,556,613,61,663
Shropshire 008,E02006019,5870,5083,787,251,485,51,357
Shropshire 009,E02006020,7108,6238,870,114,704,52,649
Shropshire 010,E02006021,7942,7184,758,125,595,38,592
Shropshire 013,E02006022,5973,5111,862,107,720,35,688
Shropshire 003,E02006023,9722,8849,873,144,648,81,637
Shropshire 006,E02006024,9575,8664,911,243,640,28,663
Shropshire 007,E02006025,9168,7870,1298,322,842,134,806
Shropshire 011,E02006026,6992,6346,646,105,513,28,516
Shropshire 012,E02006027,5308,4857,451,45,391,15,340
Shropshire 014,E02006028,9174,8250,924,123,735,66,658
Shropshire 015,E02006029,8240,7607,633,186,427,20,585
Shropshire 016,E02006030,7142,6544,598,106,468,24,514
Shropshire 017,E02006031,7381,6207,1174,182,940,52,822
Shropshire 018,E02006032,9022,8209,813,178,609,26,671
Shropshire 019,E02006033,8036,6331,1705,207,1385,113,988
Shropshire 020,E02006034,8520,7415,1105,117,931,57,849
Shropshire 021,E02006035,5710,5289,421,54,344,23,376
Shropshire 022,E02006036,6107,5290,817,126,666,25,583
Shropshire 023,E02006037,10093,8946,1147,173,885,89,872
Shropshire 024,E02006038,7612,6994,618,109,492,17,542
Shropshire 026,E02006039,7839,7158,681,161,488,32,477
Shropshire 028,E02006040,7506,6692,814,79,558,177,654
Shropshire 030,E02006041,5872,5394,478,111,334,33,371
Shropshire 032,E02006042,5878,5279,599,190,375,34,303
Shropshire 036,E02006043,6876,6174,702,154,508,40,560
Shropshire 037,E02006044,6242,5716,526,96,394,36,380
Shropshire 038,E02006045,10939,9723,1216,469,691,56,607
Shropshire 039,E02006046,8867,8073,794,201,539,54,564
Stoke-on-Trent 001,E02002951,7714,7247,467,90,369,8,472
Stoke-on-Trent 002,E02002952,6829,6096,733,130,563,40,565
Stoke-on-Trent 003,E02002953,7350,6819,531,103,418,10,490
Stoke-on-Trent 004,E02002954,8258,7631,627,114,498,15,514
Stoke-on-Trent 005,E02002955,7046,6110,936,179,725,32,855
Stoke-on-Trent 006,E02002956,9277,8438,839,137,677,25,689
Stoke-on-Trent 007,E02002957,9750,9084,666,140,508,18,588
Stoke-on-Trent 008,E02002958,7977,7230,747,105,614,28,632
Stoke-on-Trent 009,E02002959,8436,7213,1223,217,917,89,1097
Stoke-on-Trent 010,E02002960,5900,5598,302,30,256,16,355
Stoke-on-Trent 011,E02002961,6480,5570,910,140,690,80,838
Stoke-on-Trent 012,E02002962,6958,6391,567,124,438,5,414
Stoke-on-Trent 013,E02002963,7294,6522,772,132,595,45,825
Stoke-on-Trent 014,E02002964,8520,8034,486,109,362,15,470
Stoke-on-Trent 015,E02002965,7126,5554,1572,199,1195,178,1095
Stoke-on-Trent 016,E02002966,9079,5941,3138,852,1989,297,1486
Stoke-on-Trent 017,E02002967,9747,8758,989,298,662,29,675
Stoke-on-Trent 018,E02002968,9030,7509,1521,202,1221,98,1111
Stoke-on-Trent 019,E02002969,8653,7096,1557,233,1206,118,1267
Stoke-on-Trent 020,E02002970,8123,7169,954,199,724,31,764
Stoke-on-Trent 021,E02002971,5252,4784,468,68,371,29,460
Stoke-on-Trent 022,E02002972,6265,5648,617,61,549,7,499
Stoke-on-Trent 023,E02002973,8045,7099,946,168,743,35,673
Stoke-on-Trent 024,E02002974,5622,5286,336,31,293,12,276
Stoke-on-Trent 025,E02002975,7658,7218,440,54,378,8,458
Stoke-on-Trent 026,E02002976,6008,5622,386,48,324,14,394
Stoke-on-Trent 027,E02002977,5884,5368,516,36,464,16,430
Stoke-on-Trent 028,E02002978,6381,5621,760,186,547,27,514
Stoke-on-Trent 029,E02002979,5622,4974,648,108,488,52,522
Stoke-on-Trent 030,E02002980,6082,5666,416,39,364,13,337
Stoke-on-Trent 031,E02002981,8260,7559,701,106,575,20,590
Stoke-on-Trent 032,E02002982,7048,6311,737,129,581,27,531
Stoke-on-Trent 033,E02002983,5580,5213,367,64,291,12,407
Stoke-on-Trent 034,E02002984,5754,5370,384,49,321,14,417
Telford and Wrekin 001,E02002928,6003,5167,836,65,738,33,583
Telford and Wrekin 002,E02002929,6230,4993,1237,87,1026,124,910
Telford and Wrekin 003,E02002930,5533,4602,931,152,746,33,547
Telford and Wrekin 004,E02002931,6370,5893,477,50,400,27,478
Telford and Wrekin 005,E02002932,8620,7483,1137,201,869,67,799
Telford and Wrekin 006,E02002933,8207,7624,583,68,499,16,549
Telford and Wrekin 007,E02002934,6007,5479,528,38,447,43,573
Telford and Wrekin 008,E02002935,6679,6060,619,79,487,53,472
Telford and Wrekin 009,E02002936,8616,7329,1287,256,941,90,785
Telford and Wrekin 010,E02002937,10133,9209,924,132,739,53,833
Telford and Wrekin 011,E02002938,6726,5969,757,124,548,85,614
Telford and Wrekin 012,E02002939,6419,5744,675,64,570,41,622
Telford and Wrekin 013,E02002940,6084,5449,635,102,497,36,551
Telford and Wrekin 014,E02002941,9545,8558,987,143,805,39,815
Telford and Wrekin 015,E02002942,6325,5703,622,68,490,64,545
Telford and Wrekin 016,E02002943,9519,8168,1351,123,1171,57,754
Telford and Wrekin 017,E02002944,7790,6907,883,171,680,32,771
Telford and Wrekin 018,E02002945,9381,8382,999,207,715,77,857
Telford and Wrekin 019,E02002946,7900,7098,802,152,639,11,743
Telford and Wrekin 020,E02002947,6923,6012,911,185,671,55,741
Telford and Wrekin 021,E02002948,6898,5929,969,335,623,11,879
Telford and Wrekin 022,E02002949,5329,4801,528,75,441,12,457
Telford and Wrekin 023,E02002950,5404,4733,671,216,443,12,613
Cannock Chase 001,E02006118,7404,6854,550,90,434,26,447
Cannock Chase 002,E02006119,8269,7491,778,198,562,18,544
Cannock Chase 003,E02006120,8887,8183,704,194,491,19,517
Cannock Chase 004,E02006121,5548,5108,440,31,406,3,450
Cannock Chase 005,E02006122,6495,5888,607,83,497,27,573
Cannock Chase 006,E02006123,6744,6222,522,64,445,13,473
Cannock Chase 007,E02006124,7286,6647,639,136,498,5,570
Cannock Chase 008,E02006125,7331,6705,626,86,521,19,559
Cannock Chase 009,E02006126,8319,7710,609,76,512,21,520
Cannock Chase 010,E02006127,7628,6989,639,87,526,26,588
Cannock Chase 011,E02006128,8399,7723,676,88,563,25,600
Cannock Chase 012,E02006129,7673,6626,1047,135,864,48,608
Cannock Chase 013,E02006130,7479,6950,529,136,380,13,499
East Staffordshire 001,E02006131,7837,7132,705,120,545,40,598
East Staffordshire 002,E02006132,6198,5683,515,113,386,16,370
East Staffordshire 003,E02006133,6891,6197,694,157,497,40,540
East Staffordshire 004,E02006134,9164,8433,731,102,582,47,626
East Staffordshire 005,E02006135,7849,7263,586,151,405,30,529
East Staffordshire 006,E02006136,8648,7697,951,156,744,51,810
East Staffordshire 007,E02006137,8751,7644,1107,236,809,62,691
East Staffordshire 008,E02006138,6202,5336,866,139,678,49,671
East Staffordshire 009,E02006139,7061,6041,1020,182,743,95,777
East Staffordshire 010,E02006140,8466,7613,853,221,596,36,631
East Staffordshire 011,E02006141,10330,8432,1898,454,1149,295,1115
East Staffordshire 012,E02006142,5385,4988,397,68,313,16,401
East Staffordshire 013,E02006143,7231,6603,628,106,491,31,532
East Staffordshire 014,E02006144,7977,7115,862,264,569,29,620
East Staffordshire 015,E02006145,5593,5100,493,115,366,12,415
Lichfield 001,E02006146,7134,6502,632,111,508,13,489
Lichfield 002,E02006147,7626,7029,597,105,463,29,535
Lichfield 003,E02006148,7245,6771,474,53,389,32,441
Lichfield 004,E02006149,10486,9250,1236,243,934,59,962
Lichfield 005,E02006150,11610,10666,944,171,722,51,871
Lichfield 006,E02006151,8792,8141,651,137,495,19,550
Lichfield 007,E02006152,10123,9066,1057,163,841,53,760
Lichfield 008,E02006153,7050,6465,585,68,475,42,564
Lichfield 009,E02006154,9886,9228,658,79,561,18,533
Lichfield 010,E02006155,5767,5334,433,52,371,10,389
Lichfield 011,E02006156,7792,7221,571,71,480,20,531
Lichfield 012,E02006157,7143,6397,746,63,666,17,536
Newcastle-under-Lyme 001,E02006158,8486,7970,516,75,423,18,483
Newcastle-under-Lyme 002,E02006159,5754,5282,472,120,346,6,384
Newcastle-under-Lyme 003,E02006160,8356,7748,608,88,501,19,459
Newcastle-under-Lyme 004,E02006161,7032,6550,482,49,403,30,461
Newcastle-under-Lyme 005,E02006162,8437,7772,665,138,491,36,482
Newcastle-under-Lyme 006,E02006163,8032,7409,623,97,514,12,520
Newcastle-under-Lyme 007,E02006164,7421,6640,781,158,599,24,654
Newcastle-under-Lyme 008,E02006165,7384,6556,828,118,660,50,598
Newcastle-under-Lyme 009,E02006166,7193,6587,606,76,514,16,511
Newcastle-under-Lyme 010,E02006167,8722,7634,1088,142,904,42,702
Newcastle-under-Lyme 011,E02006168,8446,6508,1938,194,1585,159,1183
Newcastle-under-Lyme 012,E02006169,8077,4780,3297,652,2191,454,1722
Newcastle-under-Lyme 013,E02006170,5145,4698,447,81,358,8,333
Newcastle-under-Lyme 014,E02006171,8914,8200,714,77,610,27,721
Newcastle-under-Lyme 015,E02006172,9524,8872,652,86,534,32,633
Newcastle-under-Lyme 016,E02006173,6948,6418,530,116,383,31,466
South Staffordshire 001,E02006174,10349,9614,735,215,483,37,518
South Staffordshire 002,E02006175,6616,5928,688,85,589,14,437
South Staffordshire 003,E02006176,7342,6791,551,120,417,14,424
South Staffordshire 004,E02006177,9837,9234,603,107,477,19,547
South Staffordshire 005,E02006178,7866,7378,488,83,398,7,415
South Staffordshire 006,E02006179,7356,6559,797,63,714,20,638
South Staffordshire 007,E02006180,6700,6218,482,85,390,7,461
South Staffordshire 008,E02006181,5745,5367,378,64,302,12,361
South Staffordshire 009,E02006182,6750,6222,528,65,446,17,409
South Staffordshire 010,E02006183,7502,6936,566,130,423,13,514
South Staffordshire 011,E02006184,5430,5043,387,85,300,2,351
South Staffordshire 012,E02006185,7196,6620,576,131,430,15,416
South Staffordshire 013,E02006186,12217,11277,940,183,720,37,706
South Staffordshire 014,E02006187,7225,6690,535,115,401,19,452
Stafford 001,E02006188,5931,5519,412,50,352,10,355
Stafford 002,E02006189,7170,6539,631,107,497,27,448
Stafford 003,E02006190,10334,9213,1121,330,736,55,688
Stafford 004,E02006191,8005,7493,512,88,396,28,500
Stafford 005,E02006192,8110,7450,660,108,517,35,600
Stafford 006,E02006193,6471,6022,449,62,373,14,481
Stafford 007,E02006194,7659,6919,740,115,603,22,552
Stafford 008,E02006195,8315,7635,680,153,497,30,528
Stafford 009,E02006196,7187,5283,1904,153,1544,207,1192
Stafford 010,E02006197,8235,6219,2016,369,1476,171,1297
Stafford 011,E02006198,8477,7102,1375,83,1206,86,1129
Stafford 012,E02006199,8209,7515,694,50,577,67,631
Stafford 013,E02006200,7983,7184,799,187,599,13,646
Stafford 014,E02006201,12199,11394,805,181,543,81,674
Stafford 015,E02006202,8670,7936,734,213,482,39,563
Stafford 016,E02006203,7914,7084,830,154,651,25,713
Staffordshire Moorlands 001,E02006204,7318,6717,601,160,411,30,436
Staffordshire Moorlands 002,E02006205,7038,6608,430,59,338,33,391
Staffordshire Moorlands 003,E02006206,8358,7668,690,260,408,22,435
Staffordshire Moorlands 004,E02006207,6305,5981,324,37,275,12,250
Staffordshire Moorlands 005,E02006208,8157,7149,1008,331,643,34,608
Staffordshire Moorlands 006,E02006209,10869,10047,822,137,669,16,553
Staffordshire Moorlands 007,E02006210,5486,5068,418,80,323,15,366
Staffordshire Moorlands 008,E02006211,6472,6081,391,65,314,12,338
Staffordshire Moorlands 009,E02006212,7875,7383,492,132,352,8,359
Staffordshire Moorlands 010,E02006213,6555,6056,499,82,400,17,392
Staffordshire Moorlands 011,E02006214,6119,5591,528,105,405,18,364
Staffordshire Moorlands 012,E02006215,7844,7296,548,90,426,32,442
Staffordshire Moorlands 013,E02006216,8710,8195,515,110,393,12,430
Tamworth 001,E02006217,8817,8163,654,126,515,13,535
Tamworth 002,E02006218,7851,6921,930,165,711,54,759
Tamworth 003,E02006219,7887,7202,685,130,528,27,673
Tamworth 004,E02006220,7398,6834,564,58,489,17,572
Tamworth 005,E02006221,6087,5469,618,55,542,21,624
Tamworth 006,E02006222,6859,6322,537,61,469,7,505
Tamworth 007,E02006223,7170,6518,652,154,482,16,571
Tamworth 008,E02006224,7692,7105,587,85,488,14,565
Tamworth 009,E02006225,7375,6870,505,63,422,20,440
Tamworth 010,E02006226,9677,8729,948,157,765,26,691
North Warwickshire 001,E02006468,10486,9808,678,164,477,37,616
North Warwickshire 002,E02006469,8708,8005,703,154,534,15,598
North Warwickshire 003,E02006470,11003,9887,1116,433,647,36,601
North Warwickshire 004,E02006471,6925,6501,424,87,322,15,410
North Warwickshire 005,E02006472,8940,8116,824,138,674,12,601
North Warwickshire 006,E02006473,9925,9130,795,256,510,29,556
North Warwickshire 007,E02006474,6027,5515,512,73,418,21,452
Nuneaton and Bedworth 001,E02006475,7256,6723,533,54,457,22,404
Nuneaton and Bedworth 002,E02006476,7321,6440,881,227,632,22,610
Nuneaton and Bedworth 003,E02006477,6943,6466,477,70,395,12,448
Nuneaton and Bedworth 004,E02006478,8233,7568,665,108,529,28,749
Nuneaton and Bedworth 005,E02006479,8718,7272,1446,280,1044,122,876
Nuneaton and Bedworth 006,E02006480,7452,6774,678,89,567,22,594
Nuneaton and Bedworth 007,E02006481,6878,6269,609,107,487,15,564
Nuneaton and Bedworth 008,E02006482,6736,6073,663,96,553,14,568
Nuneaton and Bedworth 009,E02006483,7787,7008,779,147,583,49,555
Nuneaton and Bedworth 010,E02006484,7676,6916,760,118,593,49,653
Nuneaton and Bedworth 011,E02006485,6877,6520,357,35,298,24,497
Nuneaton and Bedworth 012,E02006486,7041,6521,520,92,414,14,445
Nuneaton and Bedworth 013,E02006487,6666,6104,562,90,456,16,480
Nuneaton and Bedworth 014,E02006488,6146,5781,365,68,277,20,281
Nuneaton and Bedworth 015,E02006489,8043,7292,751,103,609,39,664
Nuneaton and Bedworth 016,E02006490,7473,6843,630,129,488,13,479
Nuneaton and Bedworth 018,E02006806,8006,7338,668,77,557,34,492
Rugby 001,E02006492,11104,9770,1334,173,1057,104,1010
Rugby 002,E02006493,9047,8090,957,188,697,72,821
Rugby 003,E02006494,6754,5713,1041,127,822,92,713
Rugby 004,E02006495,7685,7095,590,105,455,30,440
Rugby 005,E02006496,6937,5654,1283,225,898,160,905
Rugby 006,E02006497,7760,6584,1176,180,899,97,758
Rugby 007,E02006498,11324,10349,975,177,731,67,769
Rugby 008,E02006499,5915,5373,542,59,466,17,403
Rugby 009,E02006500,5865,5089,776,102,590,84,591
Rugby 010,E02006501,9024,8242,782,147,587,48,580
Rugby 011,E02006502,10801,9863,938,118,769,51,642
Rugby 012,E02006503,7859,7157,702,45,606,51,563
Stratford-on-Avon 001,E02006504,5679,5203,476,65,387,24,420
Stratford-on-Avon 002,E02006505,6656,6020,636,132,479,25,440
Stratford-on-Avon 003,E02006506,5879,5408,471,122,332,17,358
Stratford-on-Avon 004,E02006507,9058,8251,807,269,512,26,475
Stratford-on-Avon 005,E02006508,9442,8642,800,131,611,58,780
Stratford-on-Avon 006,E02006509,6083,5434,649,201,418,30,449
Stratford-on-Avon 007,E02006510,6182,5696,486,56,388,42,449
Stratford-on-Avon 008,E02006511,9164,8289,875,197,609,69,642
Stratford-on-Avon 009,E02006512,10901,9336,1565,366,1079,120,998
Stratford-on-Avon 010,E02006513,7487,6672,815,151,599,65,587
Stratford-on-Avon 011,E02006514,9057,7652,1405,261,885,259,950
Stratford-on-Avon 012,E02006515,9223,8440,783,151,577,55,586
Stratford-on-Avon 013,E02006516,9019,8075,944,206,678,60,722
Stratford-on-Avon 014,E02006517,7358,6684,674,131,483,60,581
Stratford-on-Avon 015,E02006518,9297,8356,941,315,580,46,592
Warwick 001,E02006519,7565,6650,915,140,708,67,651
Warwick 002,E02006520,8388,7611,777,161,545,71,658
Warwick 003,E02006521,7463,6896,567,77,450,40,450
Warwick 004,E02006522,5464,4990,474,38,382,54,460
Warwick 005,E02006523,11628,9169,2459,85,1713,661,732
Warwick 006,E02006524,5624,5117,507,51,435,21,444
Warwick 007,E02006525,12862,10187,2675,323,2151,201,1874
Warwick 008,E02006526,8318,7567,751,117,589,45,582
Warwick 009,E02006527,9166,7285,1881,177,1511,193,1364
Warwick 010,E02006528,11142,8411,2731,364,2195,172,1944
Warwick 011,E02006529,11304,9741,1563,235,1235,93,1054
Warwick 012,E02006530,10492,9278,1214,149,931,134,1046
Warwick 013,E02006531,9931,7177,2754,392,2177,185,1738
Warwick 014,E02006532,8729,8016,713,74,596,43,636
Warwick 015,E02006533,9572,8701,871,131,690,50,730
Birmingham 001,E02001827,6045,5553,492,51,411,30,448
Birmingham 002,E02001828,6920,6311,609,76,491,42,520
Birmingham 003,E02001829,8735,8063,672,118,520,34,574
Birmingham 004,E02001830,9437,8630,807,62,702,43,801
Birmingham 005,E02001831,10326,9499,827,136,665,26,755
Birmingham 006,E02001832,8168,7547,621,54,530,37,625
Birmingham 007,E02001833,5808,5466,342,14,320,8,366
Birmingham 008,E02001834,6139,5644,495,48,430,17,523
Birmingham 009,E02001835,8176,7117,1059,86,900,73,852
Birmingham 010,E02001836,9180,8495,685,65,579,41,676
Birmingham 011,E02001837,10585,9739,846,109,702,35,789
Birmingham 012,E02001838,7673,7103,570,83,466,21,511
Birmingham 013,E02001839,6442,5927,515,21,474,20,422
Birmingham 014,E02001840,8771,7905,866,68,780,18,657
Birmingham 015,E02001841,5993,5540,453,37,399,17,459
Birmingham 016,E02001842,7663,7088,575,20,517,38,573
Birmingham 017,E02001843,6455,5895,560,36,489,35,463
Birmingham 018,E02001844,9716,8413,1303,121,1139,43,841
Birmingham 019,E02001845,6274,5805,469,40,405,24,482
Birmingham 020,E02001846,7829,7039,790,44,700,46,713
Birmingham 021,E02001847,5521,5100,421,25,382,14,371
Birmingham 022,E02001848,6372,5742,630,32,555,43,565
Birmingham 023,E02001849,6882,5986,896,81,767,48,863
Birmingham 024,E02001850,8173,7335,838,69,673,96,769
Birmingham 025,E02001851,8576,7766,810,86,708,16,641
Birmingham 026,E02001852,6544,5790,754,85,610,59,766
Birmingham 028,E02001854,7777,7138,639,55,556,28,603
Birmingham 029,E02001855,9971,9292,679,237,427,15,461
Birmingham 030,E02001856,8512,7274,1238,147,964,127,1029
Birmingham 031,E02001857,12902,11037,1865,204,1522,139,1580
Birmingham 032,E02001858,8453,7076,1377,99,1089,189,982
Birmingham 033,E02001859,10115,8191,1924,233,1275,416,1673
Birmingham 034,E02001860,8337,7235,1102,184,718,200,944
Birmingham 035,E02001861,10161,8835,1326,141,962,223,1077
Birmingham 036,E02001862,9904,8715,1189,135,856,198,991
Birmingham 037,E02001863,7839,7043,796,115,590,91,812
Birmingham 038,E02001864,5531,4956,575,46,502,27,553
Birmingham 039,E02001865,10932,9718,1214,156,835,223,1089
Birmingham 040,E02001866,8671,7831,840,114,663,63,778
Birmingham 041,E02001867,6901,6272,629,50,512,67,601
Birmingham 042,E02001868,8617,7912,705,72,583,50,567
Birmingham 043,E02001869,6060,5371,689,82,553,54,567
Birmingham 044,E02001870,11560,10599,961,151,691,119,831
Birmingham 045,E02001871,7721,7136,585,74,494,17,566
Birmingham 046,E02001872,7161,6540,621,66,534,21,466
Birmingham 047,E02001873,10534,9030,1504,101,1216,187,1348
Birmingham 048,E02001874,9352,8532,820,75,603,142,705
Birmingham 049,E02001875,8168,6794,1374,63,1181,130,1201
Birmingham 050,E02001876,11909,6474,5435,1126,3524,785,2543
Birmingham 051,E02001877,10655,9793,862,102,641,119,871
Birmingham 052,E02001878,8955,8081,874,86,687,101,852
Birmingham 053,E02001879,10376,8661,1715,105,1448,162,1280
Birmingham 054,E02001880,9434,8515,919,106,796,17,802
Birmingham 055,E02001881,9334,8559,775,67,598,110,703
Birmingham 056,E02001882,8152,7337,815,102,662,51,671
Birmingham 057,E02001883,8129,7349,780,42,705,33,577
Birmingham 058,E02001884,9239,8399,840,74,682,84,768
Birmingham 060,E02001886,8808,7253,1555,85,1315,155,1133
Birmingham 062,E02001888,6247,5714,533,19,486,28,480
Birmingham 063,E02001889,8346,7676,670,57,526,87,716
Birmingham 064,E02001890,9806,7177,2629,231,2128,270,1789
Birmingham 066,E02001892,10193,9349,844,65,709,70,830
Birmingham 067,E02001893,8097,7494,603,47,532,24,602
Birmingham 069,E02001895,7790,7188,602,41,539,22,541
Birmingham 070,E02001896,9287,8486,801,128,499,174,693
Birmingham 071,E02001897,7596,6774,822,51,707,64,772
Birmingham 072,E02001898,6488,6036,452,55,384,13,361
Birmingham 073,E02001899,7866,7060,806,71,651,84,667
Birmingham 074,E02001900,6801,4916,1885,31,1644,210,1245
Birmingham 075,E02001901,7902,6294,1608,249,1238,121,1210
Birmingham 076,E02001902,6101,5634,467,46,398,23,410
Birmingham 077,E02001903,7600,6964,636,73,455,108,601
Birmingham 078,E02001904,6939,6156,783,67,628,88,630
Birmingham 079,E02001905,9716,4839,4877,102,4194,581,3940
Birmingham 080,E02001906,9315,8645,670,43,589,38,796
Birmingham 081,E02001907,9622,8914,708,78,579,51,627
Birmingham 082,E02001908,8908,8310,598,68,376,154,724
Birmingham 083,E02001909,7986,7236,750,94,562,94,692
Birmingham 084,E02001910,7117,6503,614,80,485,49,645
Birmingham 085,E02001911,7935,7017,918,107,761,50,631
Birmingham 087,E02001913,7186,5378,1808,137,1317,354,1315
Birmingham 088,E02001914,6790,5988,802,34,683,85,767
Birmingham 089,E02001915,11507,10185,1322,160,1041,121,1143
Birmingham 090,E02001916,8612,7622,990,90,809,91,853
Birmingham 092,E02001918,8956,7529,1427,141,1170,116,1158
Birmingham 093,E02001919,6689,5787,902,58,778,66,873
Birmingham 094,E02001920,7587,6912,675,63,582,30,579
Birmingham 095,E02001921,7833,7044,789,42,682,65,703
Birmingham 096,E02001922,12650,3873,8777,2612,5234,931,3500
Birmingham 097,E02001923,10457,9523,934,99,741,94,906
Birmingham 098,E02001924,6456,5898,558,36,491,31,570
Birmingham 099,E02001925,6684,5365,1319,86,1068,165,1038
Birmingham 100,E02001926,7214,5461,1753,90,1474,189,1279
Birmingham 101,E02001927,7702,6926,776,59,684,33,697
Birmingham 102,E02001928,6858,6300,558,83,466,9,453
Birmingham 103,E02001929,9649,8829,820,73,708,39,834
Birmingham 104,E02001930,7858,6833,1025,115,853,57,794
Birmingham 105,E02001931,7886,7237,649,39,567,43,594
Birmingham 106,E02001932,6795,6051,744,71,651,22,608
Birmingham 107,E02001933,7625,6855,770,37,699,34,590
Birmingham 108,E02001934,6811,6267,544,47,456,41,484
Birmingham 109,E02001935,7839,7085,754,74,647,33,535
Birmingham 110,E02001936,6473,6009,464,32,403,29,496
Birmingham 111,E02001937,7923,7208,715,48,621,46,664
Birmingham 112,E02001938,7726,6635,1091,102,946,43,924
Birmingham 113,E02001939,5812,5190,622,71,498,53,473
Birmingham 115,E02001941,6202,5611,591,48,519,24,632
Birmingham 116,E02001942,6767,5981,786,75,671,40,667
Birmingham 117,E02001943,6394,5805,589,25,545,19,442
Birmingham 118,E02001944,8126,7343,783,73,676,34,651
Birmingham 119,E02001945,7784,7218,566,46,493,27,654
Birmingham 120,E02001946,7688,7051,637,47,573,17,627
Birmingham 121,E02001947,6165,5599,566,79,463,24,401
Birmingham 122,E02001948,7433,6872,561,53,490,18,445
Birmingham 123,E02001949,5819,5195,624,53,547,24,604
Birmingham 124,E02001950,8406,7602,804,79,686,39,637
Birmingham 125,E02001951,8217,7603,614,84,522,8,622
Birmingham 126,E02001952,8895,8035,860,58,769,33,693
Birmingham 127,E02001953,7131,6592,539,42,474,23,578
Birmingham 128,E02001954,7812,7119,693,82,589,22,564
Birmingham 129,E02001955,6381,5803,578,37,527,14,553
Birmingham 130,E02001956,6406,5869,537,67,449,21,536
Birmingham 131,E02001957,7912,7405,507,54,437,16,439
Birmingham 132,E02006807,7903,7403,500,47,416,37,579
Birmingham 133,E02006809,10032,9378,654,94,479,81,655
Birmingham 134,E02006895,7273,4706,2567,141,2014,412,1579
Birmingham 135,E02006896,5268,3255,2013,85,1670,258,1001
Birmingham 136,E02006897,6376,4483,1893,82,1562,249,1394
Birmingham 137,E02006898,6184,4488,1696,107,1380,209,1146
Birmingham 138,E02006899,5547,2886,2661,191,2045,425,1356
Birmingham 139,E02006900,14713,13319,1394,222,981,191,1382
Birmingham 140,E02006901,14402,12801,1601,255,1134,212,1207
Coventry 001,E02001958,7452,6626,826,116,649,61,722
Coventry 002,E02001959,6201,5669,532,61,417,54,433
Coventry 004,E02001961,7498,6659,839,144,626,69,689
Coventry 005,E02001962,6034,5394,640,59,488,93,578
Coventry 006,E02001963,5926,5515,411,30,351,30,381
Coventry 007,E02001964,8092,7178,914,151,701,62,760
Coventry 008,E02001965,8019,7335,684,103,524,57,670
Coventry 009,E02001966,6922,6042,880,65,622,193,694
Coventry 010,E02001967,6281,5730,551,75,436,40,421
Coventry 011,E02001968,7147,6316,831,81,650,100,671
Coventry 012,E02001969,6377,5638,739,14,640,85,652
Coventry 013,E02001970,5482,4884,598,38,463,97,456
Coventry 014,E02001971,5834,5322,512,25,458,29,560
Coventry 015,E02001972,10054,8372,1682,214,1053,415,1225
Coventry 016,E02001973,8132,6921,1211,80,909,222,825
Coventry 017,E02001974,9472,8599,873,106,716,51,737
Coventry 018,E02001975,7860,7150,710,57,548,105,573
Coventry 019,E02001976,7132,6349,783,89,631,63,713
Coventry 020,E02001977,9014,6947,2067,163,1499,405,1485
Coventry 021,E02001978,6503,5797,706,42,477,187,595
Coventry 022,E02001979,5726,5324,402,56,334,12,372
Coventry 023,E02001980,5996,5575,421,49,343,29,381
Coventry 024,E02001981,11753,8351,3402,445,2287,670,2267
Coventry 025,E02001982,7062,6247,815,75,702,38,499
Coventry 026,E02001983,7546,6674,872,52,690,130,747
Coventry 027,E02001984,8967,7901,1066,70,817,179,808
Coventry 028,E02001985,8453,4947,3506,378,2215,913,1985
Coventry 029,E02001986,7597,6675,922,127,734,61,693
Coventry 030,E02001987,5785,3771,2014,232,1529,253,1330
Coventry 031,E02001988,8786,4949,3837,338,2823,676,2113
Coventry 032,E02001989,5653,5021,632,75,486,71,490
Coventry 033,E02001990,9256,8622,634,106,476,52,547
Coventry 034,E02001991,8515,7235,1280,127,915,238,1049
Coventry 035,E02001992,9573,8478,1095,107,865,123,833
Coventry 036,E02001993,7240,6196,1044,108,832,104,722
Coventry 037,E02001994,8159,7258,901,101,652,148,783
Coventry 038,E02001995,6515,5427,1088,89,803,196,801
Coventry 039,E02001996,6819,5888,931,158,707,66,615
Coventry 040,E02001997,8526,7910,616,29,511,76,522
Coventry 041,E02001998,5973,5555,418,36,353,29,405
Coventry 042,E02001999,9398,5233,4165,233,2956,976,4009
Coventry 043,E02006805,8230,7247,983,124,733,126,724
Dudley 001,E02002000,7782,7235,547,99,439,9,497
Dudley 002,E02002001,5951,5550,401,45,346,10,361
Dudley 003,E02002002,7084,6718,366,45,311,10,380
Dudley 004,E02002003,9101,8578,523,68,446,9,497
Dudley 005,E02002004,7518,6971,547,73,468,6,494
Dudley 006,E02002005,8090,7413,677,171,481,25,570
Dudley 007,E02002006,6400,5832,568,70,487,11,521
Dudley 008,E02002007,8731,8207,524,102,417,5,480
Dudley 009,E02002008,8329,7666,663,81,560,22,597
Dudley 010,E02002009,6710,6111,599,95,470,34,551
Dudley 011,E02002010,7186,6143,1043,149,853,41,863
Dudley 012,E02002011,5864,5494,370,26,315,29,332
Dudley 013,E02002012,7790,7075,715,101,553,61,609
Dudley 014,E02002013,6697,6267,430,36,386,8,352
Dudley 015,E02002014,6929,6252,677,80,539,58,578
Dudley 016,E02002015,6024,5648,376,34,330,12,410
Dudley 017,E02002016,7826,7171,655,84,546,25,635
Dudley 018,E02002017,8279,7507,772,81,673,18,711
Dudley 019,E02002018,9036,8523,513,68,437,8,509
Dudley 020,E02002019,7857,7287,570,90,474,6,467
Dudley 021,E02002020,9451,8665,786,77,697,12,579
Dudley 022,E02002021,7315,6180,1135,150,942,43,792
Dudley 023,E02002022,8324,7604,720,100,593,27,667
Dudley 024,E02002023,5339,5077,262,32,226,4,327
Dudley 025,E02002024,8536,7956,580,110,455,15,544
Dudley 026,E02002025,7961,7323,638,106,516,16,575
Dudley 027,E02002026,7087,6700,387,43,343,1,381
Dudley 028,E02002027,5659,5341,318,44,264,10,374
Dudley 029,E02002028,5846,5423,423,70,344,9,385
Dudley 030,E02002029,5876,5521,355,24,321,10,411
Dudley 031,E02002030,6274,5667,607,46,545,16,475
Dudley 032,E02002031,6005,5443,562,54,476,32,572
Dudley 033,E02002032,9940,8937,1003,153,832,18,679
Dudley 034,E02002033,7455,6905,550,64,467,19,533
Dudley 035,E02002034,8113,7181,932,139,775,18,677
Dudley 036,E02002035,6145,5736,409,40,344,25,366
Dudley 037,E02002036,6575,5873,702,128,541,33,538
Dudley 038,E02002037,5874,5492,382,39,333,10,401
Dudley 039,E02002038,9410,8524,886,125,719,42,669
Dudley 040,E02002039,6327,5723,604,53,511,40,505
Dudley 041,E02002040,5967,5504,463,54,376,33,428
Dudley 042,E02002041,6202,5822,380,30,326,24,398
Dudley 043,E02002042,8060,7532,528,78,439,11,447
Sandwell 001,E02002043,8480,7754,726,145,556,25,633
Sandwell 002,E02002044,7498,6787,711,152,516,43,635
Sandwell 003,E02002045,7754,7201,553,99,428,26,567
Sandwell 004,E02002046,5626,5261,365,53,304,8,377
Sandwell 005,E02002047,6465,5883,582,52,512,18,510
Sandwell 006,E02002048,6420,5994,426,25,373,28,439
Sandwell 007,E02002049,5932,5361,571,56,504,11,379
Sandwell 009,E02002051,5517,5075,442,68,368,6,525
Sandwell 010,E02002052,10650,9475,1175,181,916,78,787
Sandwell 011,E02002053,5975,5602,373,27,328,18,381
Sandwell 012,E02002054,5583,5163,420,41,348,31,357
Sandwell 013,E02002055,9053,8203,850,136,636,78,693
Sandwell 014,E02002056,8624,7613,1011,146,848,17,814
Sandwell 015,E02002057,8996,8198,798,135,610,53,654
Sandwell 016,E02002058,11677,10528,1149,141,901,107,989
Sandwell 017,E02002059,10533,9105,1428,225,1064,139,903
Sandwell 018,E02002060,6273,5691,582,75,449,58,502
Sandwell 019,E02002061,5802,5174,628,92,460,76,550
Sandwell 020,E02002062,7166,6399,767,118,540,109,580
Sandwell 021,E02002063,9172,8111,1061,113,845,103,728
Sandwell 022,E02002064,11970,11053,917,160,707,50,931
Sandwell 023,E02002065,12146,10846,1300,256,750,294,1001
Sandwell 024,E02002066,7211,6445,766,68,591,107,641
Sandwell 025,E02002067,5508,5215,293,15,270,8,368
Sandwell 026,E02002068,11983,10431,1552,225,1122,205,1039
Sandwell 027,E02002069,6567,5843,724,56,646,22,602
Sandwell 028,E02002070,9140,7946,1194,121,892,181,995
Sandwell 029,E02002071,6507,5905,602,75,516,11,476
Sandwell 030,E02002072,8346,7546,800,106,626,68,782
Sandwell 031,E02002073,7550,6957,593,64,487,42,543
Sandwell 032,E02002074,8026,7448,578,52,494,32,564
Sandwell 033,E02002075,8539,7786,753,96,640,17,573
Sandwell 034,E02002076,10306,8776,1530,198,1231,101,1161
Sandwell 035,E02002077,10182,9183,999,166,789,44,866
Sandwell 036,E02002078,6205,5776,429,58,313,58,382
Sandwell 037,E02002079,7985,7276,709,111,579,19,525
Sandwell 038,E02002080,6664,6023,641,76,547,18,475
Sandwell 039,E02006810,10032,9042,990,118,829,43,779
Solihull 001,E02002081,5379,5022,357,19,324,14,334
Solihull 002,E02002082,5909,5402,507,75,427,5,483
Solihull 003,E02002083,5838,5555,283,34,240,9,290
Solihull 004,E02002084,6183,5614,569,93,467,9,527
Solihull 005,E02002085,6252,5649,603,93,500,10,575
Solihull 006,E02002086,5443,4946,497,43,448,6,434
Solihull 007,E02002087,6034,5484,550,103,436,11,545
Solihull 008,E02002088,9327,8344,983,182,774,27,653
Solihull 009,E02002089,7733,7231,502,61,420,21,536
Solihull 010,E02002090,5807,5354,453,24,412,17,418
Solihull 011,E02002091,7277,6747,530,64,440,26,457
Solihull 012,E02002092,7141,6542,599,39,540,20,506
Solihull 013,E02002093,6557,5808,749,46,660,43,632
Solihull 014,E02002094,5962,5495,467,28,409,30,475
Solihull 015,E02002095,8537,7747,790,92,635,63,662
Solihull 016,E02002096,10008,8937,1071,99,893,79,920
Solihull 017,E02002097,6555,5986,569,57,481,31,455
Solihull 018,E02002098,9418,8606,812,81,677,54,706
Solihull 019,E02002099,6561,5925,636,44,535,57,563
Solihull 021,E02002101,5843,5361,482,71,398,13,470
Solihull 022,E02002102,8592,7884,708,58,609,41,634
Solihull 023,E02002103,6025,5672,353,24,320,9,359
Solihull 024,E02002104,6166,5725,441,43,365,33,466
Solihull 025,E02002105,7815,7169,646,159,453,34,568
Solihull 026,E02002106,9275,8397,878,155,686,37,667
Solihull 027,E02002107,5783,5298,485,63,375,47,468
Solihull 028,E02002108,9797,9043,754,110,588,56,665
Solihull 029,E02002109,9357,8218,1139,253,821,65,805
Solihull 030,E02006808,6100,5641,459,33,403,23,428
Walsall 001,E02002110,6753,6232,521,76,433,12,472
Walsall 002,E02002111,5923,5465,458,79,359,20,363
Walsall 003,E02002112,5435,5099,336,57,263,16,422
Walsall 004,E02002113,6468,5935,533,60,459,14,509
Walsall 005,E02002114,6033,5651,382,40,333,9,400
Walsall 006,E02002115,6564,6082,482,45,428,9,500
Walsall 007,E02002116,6739,6321,418,44,367,7,424
Walsall 008,E02002117,6051,5615,436,41,391,4,405
Walsall 009,E02002118,7195,6644,551,107,437,7,474
Walsall 010,E02002119,5990,5498,492,42,440,10,396
Walsall 011,E02002120,6266,5901,365,32,325,8,439
Walsall 012,E02002121,6211,5542,669,60,589,20,518
Walsall 013,E02002122,5518,4931,587,67,510,10,591
Walsall 014,E02002123,6431,5969,462,63,392,7,410
Walsall 015,E02002124,6893,6283,610,75,526,9,476
Walsall 016,E02002125,5918,5408,510,56,437,17,412
Walsall 017,E02002126,6342,5671,671,87,577,7,601
Walsall 018,E02002127,8331,7350,981,122,824,35,746
Walsall 019,E02002128,5547,5123,424,45,373,6,326
Walsall 020,E02002129,5902,5533,369,35,321,13,331
Walsall 021,E02002130,6594,5980,614,83,520,11,450
Walsall 022,E02002131,7847,7339,508,79,399,30,453
Walsall 023,E02002132,6371,5735,636,101,523,12,429
Walsall 024,E02002133,6645,5814,831,120,673,38,657
Walsall 025,E02002134,8221,7323,898,144,746,8,735
Walsall 026,E02002135,7081,6196,885,112,705,68,728
Walsall 027,E02002136,7562,6663,899,104,767,28,759
Walsall 028,E02002137,6285,5899,386,44,328,14,363
Walsall 029,E02002138,6303,5800,503,42,423,38,491
Walsall 030,E02002139,9498,7769,1729,212,1362,155,1214
Walsall 031,E02002140,8021,7128,893,164,684,45,810
Walsall 032,E02002141,6690,6183,507,43,455,9,365
Walsall 033,E02002142,6793,6109,684,113,535,36,622
Walsall 034,E02002143,10027,9012,1015,236,705,74,785
Walsall 035,E02002144,6703,6212,491,56,411,24,431
Walsall 036,E02002145,6799,5879,920,126,780,14,585
Walsall 037,E02002146,6505,5909,596,50,522,24,452
Walsall 038,E02002147,7858,7070,788,161,607,20,564
Walsall 039,E02002148,11010,10257,753,108,621,24,654
Wolverhampton 001,E02002149,10027,9332,695,142,533,20,625
Wolverhampton 002,E02002150,5715,5335,380,61,295,24,347
Wolverhampton 003,E02002151,5826,5353,473,69,394,10,395
Wolverhampton 004,E02002152,6232,5685,547,74,460,13,516
Wolverhampton 005,E02002153,7502,7057,445,91,347,7,340
Wolverhampton 006,E02002154,5580,5117,463,37,407,19,410
Wolverhampton 007,E02002155,5829,5204,625,109,505,11,364
Wolverhampton 008,E02002156,8365,7775,590,79,484,27,526
Wolverhampton 009,E02002157,7742,7236,506,57,431,18,528
Wolverhampton 010,E02002158,7659,7138,521,92,426,3,468
Wolverhampton 011,E02002159,6023,5382,641,89,492,60,716
Wolverhampton 012,E02002160,7048,6482,566,51,490,25,444
Wolverhampton 013,E02002161,6288,5494,794,132,561,101,873
Wolverhampton 014,E02002162,7556,6955,601,63,486,52,530
Wolverhampton 015,E02002163,11250,9750,1500,284,1082,134,1310
Wolverhampton 016,E02002164,6843,5094,1749,310,1040,399,1179
Wolverhampton 017,E02002165,7729,6155,1574,236,1195,143,1041
Wolverhampton 018,E02002166,9056,8173,883,175,679,29,684
Wolverhampton 019,E02002167,6548,6083,465,22,415,28,394
Wolverhampton 020,E02002168,10321,8157,2164,244,1645,275,1349
Wolverhampton 021,E02002169,8647,7977,670,72,560,38,609
Wolverhampton 022,E02002170,6253,5767,486,65,405,16,466
Wolverhampton 023,E02002171,7367,6835,532,73,436,23,554
Wolverhampton 026,E02002174,7578,6913,665,66,579,20,605
Wolverhampton 027,E02002175,7031,6277,754,130,600,24,608
Wolverhampton 028,E02002176,7692,7227,465,58,388,19,440
Wolverhampton 029,E02002177,9032,8040,992,141,772,79,861
Wolverhampton 030,E02002178,8114,7448,666,65,557,44,573
Wolverhampton 031,E02002179,6401,5980,421,35,367,19,410
Wolverhampton 032,E02002180,6392,5953,439,69,363,7,342
Wolverhampton 033,E02002181,7079,6506,573,142,418,13,445
Wolverhampton 034,E02002182,6645,6187,458,83,358,17,466
Wolverhampton 035,E02006894,12100,10575,1525,316,974,235,1205
Bromsgrove 001,E02006696,6270,5699,571,113,440,18,505
Bromsgrove 002,E02006697,7266,6624,642,91,534,17,502
Bromsgrove 003,E02006698,6491,6101,390,57,325,8,400
Bromsgrove 004,E02006699,5939,5536,403,47,341,15,367
Bromsgrove 005,E02006700,5739,5321,418,28,367,23,362
Bromsgrove 006,E02006701,6033,5542,491,65,396,30,467
Bromsgrove 007,E02006702,5808,5357,451,51,390,10,429
Bromsgrove 008,E02006703,7174,6658,516,35,446,35,569
Bromsgrove 009,E02006704,6564,5944,620,128,470,22,428
Bromsgrove 010,E02006705,6696,6063,633,72,542,19,489
Bromsgrove 011,E02006706,6804,5930,874,102,653,119,664
Bromsgrove 012,E02006707,6867,6336,531,103,405,23,411
Bromsgrove 013,E02006708,8102,7211,891,168,705,18,730
Bromsgrove 014,E02006709,7884,6742,1142,68,1030,44,741
Malvern Hills 001,E02006710,7867,7188,679,173,440,66,532
Malvern Hills 002,E02006711,7847,7183,664,84,537,43,626
Malvern Hills 003,E02006712,6929,6389,540,51,463,26,515
Malvern Hills 004,E02006713,6155,5486,669,90,547,32,575
Malvern Hills 005,E02006714,5262,4827,435,45,373,17,452
Malvern Hills 006,E02006715,8223,7161,1062,146,870,46,647
Malvern Hills 007,E02006716,6425,5834,591,120,447,24,492
Malvern Hills 008,E02006717,5691,5256,435,55,369,11,342
Malvern Hills 009,E02006718,6131,5466,665,85,491,89,456
Malvern Hills 010,E02006719,7273,6204,1069,139,707,223,803
Malvern Hills 011,E02006720,6828,6232,596,104,444,48,499
Redditch 001,E02006721,5705,5015,690,53,611,26,398
Redditch 002,E02006722,5489,4920,569,91,447,31,501
Redditch 003,E02006723,8282,7351,931,180,721,30,741
Redditch 004,E02006724,6878,5953,925,173,624,128,756
Redditch 005,E02006725,5662,5146,516,62,409,45,505
Redditch 006,E02006726,6411,5682,729,88,591,50,627
Redditch 007,E02006727,6083,5636,447,35,383,29,496
Redditch 008,E02006728,7060,6447,613,73,527,13,498
Redditch 009,E02006729,7282,6640,642,52,553,37,596
Redditch 010,E02006730,6188,5571,617,83,506,28,549
Redditch 011,E02006731,5829,5331,498,49,435,14,570
Redditch 012,E02006732,7293,6605,688,80,587,21,502
Redditch 013,E02006733,6052,5428,624,101,505,18,482
Worcester 001,E02006734,8175,7490,685,105,548,32,614
Worcester 002,E02006735,5205,4707,498,52,434,12,426
Worcester 003,E02006736,6734,5961,773,111,632,30,690
Worcester 004,E02006737,7803,6964,839,74,724,41,733
Worcester 005,E02006738,8966,7939,1027,206,777,44,816
Worcester 006,E02006739,5912,4292,1620,216,1293,111,1082
Worcester 007,E02006740,6979,5101,1878,202,1533,143,1169
Worcester 008,E02006741,5639,5055,584,59,508,17,599
Worcester 009,E02006742,8420,6883,1537,228,1261,48,888
Worcester 010,E02006743,6560,5807,753,141,573,39,589
Worcester 011,E02006744,7015,5673,1342,170,1079,93,1011
Worcester 012,E02006745,7890,7169,721,120,572,29,642
Worcester 013,E02006746,7619,6602,1017,107,868,42,844
Worcester 014,E02006747,5851,5352,499,54,430,15,521
Wychavon 001,E02006748,6662,6097,565,39,505,21,501
Wychavon 002,E02006749,5384,4958,426,83,323,20,419
Wychavon 003,E02006750,5430,4866,564,63,473,28,394
Wychavon 004,E02006751,5927,5441,486,74,394,18,430
Wychavon 005,E02006752,6763,6313,450,41,380,29,345
Wychavon 006,E02006753,6301,5814,487,69,392,26,471
Wychavon 007,E02006754,5475,5045,430,46,371,13,354
Wychavon 008,E02006755,5374,4964,410,47,337,26,372
Wychavon 009,E02006756,5366,4990,376,18,353,5,398
Wychavon 010,E02006757,6840,6262,578,71,460,47,456
Wychavon 011,E02006758,5628,5185,443,54,371,18,496
Wychavon 012,E02006759,7065,6389,676,207,429,40,421
Wychavon 013,E02006760,7923,7178,745,119,590,36,569
Wychavon 014,E02006761,5833,4850,983,241,656,86,624
Wychavon 015,E02006762,5713,5187,526,60,445,21,484
Wychavon 016,E02006763,6467,5970,497,70,406,21,499
Wychavon 017,E02006764,5415,4926,489,49,421,19,473
Wychavon 018,E02006765,5872,5251,621,88,493,40,408
Wychavon 019,E02006766,7506,6965,541,97,413,31,511
Wyre Forest 001,E02006767,8848,8094,754,65,661,28,569
Wyre Forest 002,E02006768,6790,6310,480,48,419,13,472
Wyre Forest 003,E02006769,7171,6603,568,56,497,15,564
Wyre Forest 004,E02006770,7166,6263,903,144,727,32,681
Wyre Forest 005,E02006771,6576,6028,548,81,446,21,450
Wyre Forest 006,E02006772,6445,5947,498,56,432,10,426
Wyre Forest 007,E02006773,8301,7494,807,97,689,21,662
Wyre Forest 008,E02006774,7482,6613,869,113,727,29,774
Wyre Forest 009,E02006775,5164,4668,496,88,395,13,394
Wyre Forest 010,E02006776,6579,6029,550,72,450,28,501
Wyre Forest 011,E02006777,7161,6566,595,145,431,19,575
Wyre Forest 012,E02006778,6879,6435,444,61,369,14,473
Wyre Forest 013,E02006779,7622,6846,776,144,591,41,551
Wyre Forest 014,E02006780,5791,5344,447,98,334,15,325
Bedford 001,E02003616,5675,5147,528,82,407,39,449
Bedford 002,E02003617,8947,8048,899,192,654,53,680
Bedford 003,E02003618,8768,7956,812,175,582,55,552
Bedford 004,E02003619,10034,8979,1055,95,903,57,685
Bedford 005,E02003620,8153,7569,584,65,478,41,634
Bedford 006,E02003621,8072,7423,649,75,528,46,538
Bedford 007,E02003622,9090,8218,872,83,708,81,771
Bedford 008,E02003623,8144,7243,901,124,732,45,534
Bedford 009,E02003624,6008,4485,1523,98,1279,146,976
Bedford 010,E02003625,8248,6420,1828,251,1399,178,1202
Bedford 011,E02003626,5395,4808,587,70,486,31,612
Bedford 012,E02003627,9069,7182,1887,251,1401,235,1312
Bedford 013,E02003628,8552,7537,1015,242,594,179,671
Bedford 014,E02003629,9468,8470,998,160,762,76,795
Bedford 015,E02003630,9681,8326,1355,179,944,232,1120
Bedford 016,E02003631,5475,4997,478,56,383,39,435
Bedford 017,E02003632,6061,5446,615,76,485,54,590
Bedford 018,E02003633,7794,7049,745,72,644,29,563
Bedford 019,E02003634,9499,8393,1106,117,938,51,645
Bedford 020,E02003635,5346,4961,385,62,310,13,325
Central Bedfordshire 001,E02003599,5601,5085,516,94,399,23,411
Central Bedfordshire 002,E02003600,6056,5431,625,93,501,31,445
Central Bedfordshire 003,E02003601,7199,6566,633,137,477,19,518
Central Bedfordshire 004,E02003602,5946,5545,401,51,325,25,415
Central Bedfordshire 005,E02003603,9611,8438,1173,274,859,40,800
Central Bedfordshire 006,E02003604,6940,6203,737,100,610,27,448
Central Bedfordshire 007,E02003605,8312,6657,1655,154,736,765,893
Central Bedfordshire 008,E02003606,7583,6946,637,79,483,75,502
Central Bedfordshire 009,E02003607,8487,7647,840,153,565,122,721
Central Bedfordshire 010,E02003608,10928,9899,1029,198,785,46,707
Central Bedfordshire 011,E02003609,10017,8833,1184,184,906,94,847
Central Bedfordshire 012,E02003610,7175,6386,789,178,547,64,496
Central Bedfordshire 013,E02003611,8480,7558,922,104,711,107,850
Central Bedfordshire 014,E02003612,9632,8398,1234,251,927,56,555
Central Bedfordshire 015,E02003613,5861,5358,503,72,402,29,398
Central Bedfordshire 016,E02003614,7373,6741,632,130,433,69,538
Central Bedfordshire 017,E02003615,8788,8033,755,140,568,47,564
Central Bedfordshire 018,E02003636,7312,6737,575,107,437,31,470
Central Bedfordshire 019,E02003637,9389,8500,889,160,682,47,638
Central Bedfordshire 020,E02003638,7501,6969,532,60,428,44,527
Central Bedfordshire 021,E02003639,8645,7549,1096,180,878,38,787
Central Bedfordshire 022,E02003640,6010,5363,647,77,516,54,497
Central Bedfordshire 023,E02003641,5474,5033,441,61,348,32,397
Central Bedfordshire 025,E02003642,8796,7964,832,133,623,76,666
Central Bedfordshire 024,E02003643,9839,8659,1180,245,894,41,747
Central Bedfordshire 026,E02003644,8487,7636,851,95,728,28,600
Central Bedfordshire 027,E02003645,6746,6288,458,56,384,18,461
Central Bedfordshire 028,E02003646,8865,8002,863,91,740,32,604
Central Bedfordshire 029,E02003647,8574,7437,1137,171,882,84,823
Central Bedfordshire 030,E02003648,5193,4665,528,50,446,32,393
Central Bedfordshire 031,E02003649,6875,6297,578,49,488,41,488
Central Bedfordshire 032,E02003650,6760,6236,524,31,444,49,473
Central Bedfordshire 033,E02003651,5926,5474,452,93,341,18,470
Luton 001,E02003258,8486,7847,639,82,523,34,612
Luton 002,E02003259,6431,5743,688,61,599,28,551
Luton 003,E02003260,8392,7540,852,191,613,48,733
Luton 004,E02003261,6039,5583,456,43,385,28,390
Luton 005,E02003262,9812,8890,922,115,741,66,885
Luton 006,E02003263,11760,10610,1150,143,915,92,1012
Luton 007,E02003264,9326,8577,749,73,591,85,939
Luton 008,E02003265,8233,7596,637,89,514,34,591
Luton 009,E02003266,9268,8496,772,107,608,57,650
Luton 010,E02003267,13253,11859,1394,183,960,251,1065
Luton 011,E02003268,10907,9699,1208,132,919,157,854
Luton 012,E02003269,9985,8951,1034,143,802,89,842
Luton 013,E02003270,8000,7133,867,151,594,122,636
Luton 014,E02003271,9775,8824,951,184,679,88,785
Luton 015,E02003272,10490,9386,1104,172,675,257,1001
Luton 016,E02003273,10286,9305,981,113,754,114,1020
Luton 017,E02003274,10849,9041,1808,260,1122,426,1246
Luton 018,E02003275,11733,8078,3655,509,2348,798,2334
Luton 019,E02003276,8445,7036,1409,158,879,372,1070
Luton 020,E02003277,10190,8912,1278,175,942,161,897
Luton 021,E02003278,11541,8519,3022,463,1961,598,1574
Peterborough 001,E02003237,6216,5690,526,35,448,43,460
Peterborough 002,E02003238,5927,5369,558,64,475,19,546
Peterborough 003,E02003239,7898,7280,618,80,516,22,574
Peterborough 004,E02003240,6629,5651,978,126,744,108,965
Peterborough 005,E02003241,6138,5554,584,99,466,19,436
Peterborough 006,E02003242,7925,7259,666,74,542,50,651
Peterborough 007,E02003243,9741,8505,1236,187,945,104,887
Peterborough 008,E02003244,8826,7771,1055,119,802,134,828
Peterborough 009,E02003245,7658,6641,1017,174,768,75,848
Peterborough 010,E02003246,9097,7519,1578,163,1047,368,1240
Peterborough 011,E02003247,7862,6820,1042,174,791,77,808
Peterborough 012,E02003248,10337,8722,1615,251,989,375,1322
Peterborough 013,E02003249,10563,9151,1412,177,1061,174,1139
Peterborough 014,E02003250,10022,8010,2012,329,1210,473,1580
Peterborough 015,E02003251,7118,6475,643,75,514,54,602
Peterborough 016,E02003252,10250,8588,1662,213,1196,253,1383
Peterborough 017,E02003253,8392,6988,1404,173,1122,109,1046
Peterborough 018,E02003254,8646,7866,780,106,635,39,649
Peterborough 019,E02003255,8807,7920,887,174,683,30,759
Peterborough 021,E02003257,8626,7474,1152,276,792,84,888
Peterborough 022,E02006877,7901,6744,1157,96,1002,59,819
Peterborough 023,E02006878,9052,7287,1765,274,1396,95,876
Southend-on-Sea 001,E02003279,9364,8719,645,105,523,17,532
Southend-on-Sea 002,E02003280,9726,9006,720,79,617,24,725
Southend-on-Sea 003,E02003281,9219,8487,732,78,625,29,683
Southend-on-Sea 004,E02003282,9971,9054,917,75,777,65,819
Southend-on-Sea 005,E02003283,10475,9502,973,58,876,39,805
Southend-on-Sea 006,E02003284,11213,10119,1094,134,920,40,1062
Southend-on-Sea 007,E02003285,10847,9556,1291,169,1062,60,1141
Southend-on-Sea 008,E02003286,9154,8250,904,116,735,53,698
Southend-on-Sea 009,E02003287,9710,8875,835,48,739,48,714
Southend-on-Sea 010,E02003288,11004,9330,1674,217,1340,117,1279
Southend-on-Sea 011,E02003289,10083,8779,1304,207,1044,53,927
Southend-on-Sea 012,E02003290,10045,8508,1537,111,1361,65,1179
Southend-on-Sea 013,E02003291,11159,10089,1070,171,851,48,769
Southend-on-Sea 014,E02003292,11130,9117,2013,328,1544,141,1441
Southend-on-Sea 015,E02003293,11063,8506,2557,340,1882,335,1520
Southend-on-Sea 016,E02003294,9215,8396,819,101,669,49,695
Southend-on-Sea 017,E02003295,10280,9494,786,109,630,47,746
Thurrock 001,E02003296,7040,6659,381,59,306,16,422
Thurrock 002,E02003297,7213,6653,560,84,457,19,402
Thurrock 003,E02003298,7060,6611,449,44,391,14,453
Thurrock 004,E02003299,6115,5724,391,52,309,30,340
Thurrock 005,E02003300,7658,6916,742,147,588,7,564
Thurrock 006,E02003301,9486,8609,877,85,732,60,564
Thurrock 007,E02003302,9974,9138,836,153,661,22,703
Thurrock 008,E02003303,7736,7156,580,56,502,22,479
Thurrock 009,E02003304,9314,8725,589,38,518,33,571
Thurrock 010,E02003305,5770,5311,459,38,406,15,396
Thurrock 012,E02003307,9865,9046,819,154,620,45,631
Thurrock 013,E02003308,6364,5816,548,153,371,24,414
Thurrock 014,E02003309,7425,6757,668,62,549,57,569
Thurrock 015,E02003310,11654,9796,1858,281,1432,145,1193
Thurrock 016,E02003311,8435,7251,1184,191,849,144,847
Thurrock 017,E02003312,8086,6774,1312,246,926,140,987
Thurrock 018,E02003313,13055,11661,1394,404,859,131,869
Thurrock 019,E02006859,7384,6439,945,142,721,82,653
Thurrock 020,E02006926,8071,7252,819,70,676,73,714
Cambridge 001,E02003719,9142,7536,1606,161,1203,242,1076
Cambridge 002,E02003720,9070,7382,1688,128,1284,276,1276
Cambridge 003,E02003721,9405,7677,1728,168,1325,235,1266
Cambridge 004,E02003722,8629,6792,1837,112,1317,408,1339
Cambridge 005,E02003723,9785,6591,3194,204,2237,753,1900
Cambridge 006,E02003724,9907,8182,1725,159,1256,310,1276
Cambridge 007,E02003725,15017,9798,5219,413,3433,1373,3554
Cambridge 008,E02003726,8333,5561,2772,282,1835,655,2059
Cambridge 009,E02003727,9252,6669,2583,267,2003,313,1944
Cambridge 010,E02003728,9386,7256,2130,156,1602,372,1718
Cambridge 011,E02003729,8780,7549,1231,110,914,207,977
Cambridge 012,E02003730,8034,6231,1803,120,1396,287,1317
Cambridge 013,E02003731,9127,7408,1719,144,1311,264,1364
East Cambridgeshire 001,E02003732,8738,7551,1187,344,731,112,525
East Cambridgeshire 002,E02003733,8376,7573,803,157,600,46,588
East Cambridgeshire 003,E02003734,11773,10317,1456,249,1018,189,1053
East Cambridgeshire 004,E02003735,8483,7208,1275,205,866,204,705
East Cambridgeshire 005,E02003736,9900,9054,846,173,606,67,682
East Cambridgeshire 006,E02003737,11699,10308,1391,523,715,153,677
East Cambridgeshire 007,E02003738,6146,5613,533,68,348,117,418
East Cambridgeshire 008,E02003739,6309,5749,560,151,365,44,465
East Cambridgeshire 009,E02003740,6039,5382,657,112,478,67,395
East Cambridgeshire 011,E02006825,6355,5739,616,86,435,95,432
Fenland 001,E02003742,6305,5695,610,108,471,31,477
Fenland 002,E02003743,10173,8873,1300,376,658,266,924
Fenland 003,E02003744,12668,10973,1695,480,959,256,1080
Fenland 004,E02003745,9690,8811,879,137,698,44,670
Fenland 005,E02003746,7835,6983,852,146,649,57,647
Fenland 006,E02003747,11197,10100,1097,448,618,31,558
Fenland 007,E02003748,7430,6608,822,158,620,44,545
Fenland 008,E02003749,5998,5491,507,75,410,22,468
Fenland 009,E02003750,7033,6395,638,110,494,34,490
Fenland 010,E02003751,6480,5855,625,154,430,41,458
Fenland 011,E02003752,10453,9293,1160,425,675,60,729
Huntingdonshire 001,E02003753,11041,9930,1111,324,723,64,767
Huntingdonshire 002,E02003754,5758,5269,489,92,335,62,396
Huntingdonshire 003,E02003755,8479,7578,901,274,585,42,580
Huntingdonshire 004,E02003756,6536,6018,518,114,349,55,379
Huntingdonshire 005,E02003757,6354,5713,641,115,462,64,465
Huntingdonshire 006,E02003758,9375,8362,1013,137,789,87,867
Huntingdonshire 007,E02003759,6126,5557,569,116,426,27,445
Huntingdonshire 008,E02003760,8377,7327,1050,296,605,149,789
Huntingdonshire 009,E02003761,5957,5342,615,85,470,60,517
Huntingdonshire 010,E02003762,8571,7545,1026,136,595,295,702
Huntingdonshire 011,E02003763,9869,8835,1034,290,660,84,805
Huntingdonshire 012,E02003764,9398,7779,1619,264,1154,201,974
Huntingdonshire 013,E02003765,6515,5680,835,141,620,74,568
Huntingdonshire 014,E02003766,6711,5922,789,124,625,40,516
Huntingdonshire 015,E02003767,6528,5918,610,80,448,82,473
Huntingdonshire 016,E02003768,9278,8464,814,149,567,98,639
Huntingdonshire 017,E02003769,7433,6440,993,91,839,63,641
Huntingdonshire 018,E02003770,7934,6629,1305,102,1164,39,464
Huntingdonshire 019,E02003771,6272,5488,784,124,576,84,557
Huntingdonshire 020,E02003772,6815,6171,644,92,517,35,555
Huntingdonshire 021,E02003773,10477,9387,1090,228,799,63,831
Huntingdonshire 022,E02003774,5704,5166,538,58,433,47,574
South Cambridgeshire 001,E02003775,6877,6236,641,149,451,41,567
South Cambridgeshire 002,E02003776,6543,5895,648,170,439,39,514
South Cambridgeshire 003,E02003777,6647,5971,676,111,511,54,556
South Cambridgeshire 004,E02003778,6014,5015,999,121,791,87,654
South Cambridgeshire 005,E02003779,5048,4546,502,81,380,41,437
South Cambridgeshire 006,E02003780,10600,9137,1463,216,1084,163,935
South Cambridgeshire 007,E02003781,6361,5574,787,80,594,113,649
South Cambridgeshire 009,E02003783,7065,6122,943,58,728,157,747
South Cambridgeshire 010,E02003784,8643,7966,677,135,474,68,608
South Cambridgeshire 011,E02003785,8695,7492,1203,222,805,176,854
South Cambridgeshire 012,E02003786,6104,5438,666,65,524,77,528
South Cambridgeshire 013,E02003787,7229,6642,587,107,446,34,475
South Cambridgeshire 014,E02003788,6359,5818,541,54,442,45,430
South Cambridgeshire 015,E02003789,7145,6470,675,150,474,51,449
South Cambridgeshire 016,E02003790,9528,8756,772,174,535,63,579
South Cambridgeshire 017,E02003791,7816,6986,830,111,652,67,616
South Cambridgeshire 018,E02003792,9367,8568,799,114,629,56,647
South Cambridgeshire 019,E02003793,7492,6654,838,144,585,109,743
South Cambridgeshire 020,E02006873,7185,5844,1341,281,934,126,557
South Cambridgeshire 021,E02006874,8037,7206,831,124,622,85,699
Basildon 001,E02004424,7133,6622,511,54,427,30,441
Basildon 002,E02004425,7347,6705,642,103,505,34,555
Basildon 003,E02004426,7815,7147,668,58,558,52,583
Basildon 004,E02004427,7562,7017,545,80,437,28,474
Basildon 005,E02004428,6176,5648,528,27,494,7,380
Basildon 006,E02004429,7513,7049,464,38,404,22,431
Basildon 007,E02004430,8062,7553,509,64,420,25,544
Basildon 008,E02004431,9071,8291,780,114,649,17,694
Basildon 009,E02004432,6892,6433,459,51,387,21,442
Basildon 010,E02004433,8611,7519,1092,88,950,54,785
Basildon 011,E02004434,8385,7631,754,83,641,30,769
Basildon 012,E02004435,8036,7363,673,61,587,25,625
Basildon 013,E02004436,7700,6934,766,91,657,18,781
Basildon 014,E02004437,7863,7050,813,95,676,42,651
Basildon 015,E02004438,8621,7608,1013,103,867,43,791
Basildon 016,E02004439,8779,7808,971,101,825,45,810
Basildon 017,E02004440,7880,7204,676,67,567,42,703
Basildon 018,E02004441,7455,6887,568,48,486,34,567
Basildon 019,E02004442,8187,7343,844,99,719,26,711
Basildon 020,E02004443,8171,7434,737,101,554,82,722
Basildon 021,E02004444,9064,8262,802,142,610,50,663
Basildon 022,E02004445,8174,7334,840,79,728,33,813
Braintree 001,E02004446,6878,6368,510,59,416,35,507
Braintree 002,E02004447,5839,5438,401,54,322,25,416
Braintree 003,E02004448,6349,5820,529,73,431,25,382
Braintree 004,E02004449,8483,7445,1038,283,711,44,571
Braintree 005,E02004450,6030,5467,563,104,430,29,535
Braintree 006,E02004451,8664,7947,717,151,552,14,580
Braintree 007,E02004452,9291,8422,869,86,730,53,706
Braintree 008,E02004453,7091,6290,801,96,688,17,608
Braintree 009,E02004454,8921,7389,1532,187,1204,141,993
Braintree 010,E02004455,7634,7031,603,68,507,28,555
Braintree 011,E02004456,8913,7919,994,104,842,48,734
Braintree 012,E02004457,10331,9350,981,139,785,57,725
Braintree 013,E02004458,9519,8652,867,120,709,38,697
Braintree 014,E02004459,10349,9316,1033,283,692,58,660
Braintree 015,E02004460,8855,8154,701,106,567,28,605
Braintree 016,E02004461,5820,5373,447,32,395,20,448
Braintree 017,E02004462,10135,8736,1399,224,1106,69,908
Braintree 018,E02004463,7982,7277,705,97,577,31,580
Brentwood 001,E02004464,9765,9220,545,64,449,32,572
Brentwood 002,E02004465,5966,5565,401,77,290,34,367
Brentwood 003,E02004466,8084,7443,641,96,503,42,529
Brentwood 004,E02004467,7574,6856,718,65,604,49,590
Brentwood 005,E02004468,10452,9580,872,177,611,84,715
Brentwood 006,E02004469,6862,6344,518,64,428,26,518
Brentwood 007,E02004470,10667,8874,1793,261,1347,185,1202
Brentwood 008,E02004471,8045,7242,803,83,674,46,649
Brentwood 009,E02004472,6186,5693,493,38,416,39,497
Castle Point 001,E02004473,7674,7170,504,61,429,14,493
Castle Point 002,E02004474,7129,6586,543,75,451,17,546
Castle Point 003,E02004475,6533,6156,377,21,343,13,436
Castle Point 004,E02004476,8002,7465,537,63,456,18,568
Castle Point 005,E02004477,5949,5532,417,47,353,17,380
Castle Point 006,E02004478,6605,5932,673,77,568,28,468
Castle Point 007,E02004479,7949,7379,570,96,453,21,524
Castle Point 008,E02004480,7112,6541,571,64,492,15,456
Castle Point 009,E02004481,6735,6186,549,50,482,17,429
Castle Point 010,E02004482,8394,7703,691,140,538,13,593
Castle Point 011,E02004483,8166,7426,740,51,660,29,490
Castle Point 012,E02004484,7763,7152,611,95,496,20,752
Chelmsford 001,E02004485,7006,6420,586,41,513,32,485
Chelmsford 002,E02004486,8197,7305,892,78,732,82,714
Chelmsford 003,E02004487,7077,6467,610,29,531,50,581
Chelmsford 004,E02004488,8254,7588,666,76,555,35,579
Chelmsford 005,E02004489,9209,8252,957,151,726,80,749
Chelmsford 006,E02004490,7716,6829,887,129,715,43,643
Chelmsford 007,E02004491,7370,6752,618,70,501,47,581
Chelmsford 008,E02004492,9290,8261,1029,112,835,82,1023
Chelmsford 009,E02004493,10127,8581,1546,161,1257,128,1343
Chelmsford 010,E02004494,9565,7065,2500,382,1898,220,1686
Chelmsford 011,E02004495,8186,7359,827,87,673,67,616
Chelmsford 012,E02004496,7403,6692,711,50,623,38,585
Chelmsford 013,E02004497,7848,7228,620,44,546,30,537
Chelmsford 014,E02004498,9720,8695,1025,90,885,50,833
Chelmsford 015,E02004499,6927,6489,438,55,364,19,440
Chelmsford 016,E02004500,9147,8461,686,109,531,46,656
Chelmsford 017,E02004501,7243,6609,634,71,532,31,522
Chelmsford 018,E02004502,6551,6049,502,60,422,20,471
Chelmsford 019,E02004503,8087,7389,698,130,536,32,519
Chelmsford 020,E02004504,8366,7644,722,148,529,45,649
Chelmsford 021,E02004505,5021,4647,374,29,334,11,301
Colchester 001,E02004506,6798,6246,552,67,462,23,449
Colchester 002,E02004507,9987,8764,1223,198,942,83,1011
Colchester 003,E02004508,6551,6112,439,66,349,24,430
Colchester 004,E02004509,10565,8625,1940,277,1537,126,1289
Colchester 007,E02004512,9996,7703,2293,271,1742,280,1495
Colchester 008,E02004513,10991,7864,3127,578,2077,472,1568
Colchester 009,E02004514,5549,4979,570,21,525,24,578
Colchester 010,E02004515,7161,6578,583,75,480,28,504
Colchester 011,E02004516,10682,8398,2284,259,1812,213,1545
Colchester 012,E02004517,8283,7576,707,102,567,38,575
Colchester 013,E02004518,6208,5271,937,107,757,73,699
Colchester 014,E02004519,7396,6891,505,45,432,28,530
Colchester 015,E02004520,8360,6828,1532,277,1082,173,1330
Colchester 016,E02004521,8814,7659,1155,181,902,72,911
Colchester 017,E02004522,10025,7120,2905,380,1717,808,1868
Colchester 018,E02004523,9014,7961,1053,139,849,65,971
Colchester 019,E02004524,8247,7689,558,56,473,29,502
Colchester 020,E02004525,7583,7021,562,130,406,26,499
Colchester 021,E02004526,7183,6483,700,303,364,33,348
Colchester 022,E02006922,13681,12306,1375,157,1100,118,1228
Epping Forest 001,E02004527,8629,7754,875,77,768,30,668
Epping Forest 002,E02004528,8037,7578,459,43,387,29,565
Epping Forest 003,E02004529,6615,6152,463,43,382,38,430
Epping Forest 004,E02004530,6251,5694,557,111,422,24,393
Epping Forest 005,E02004531,6238,5635,603,62,511,30,407
Epping Forest 006,E02004532,6192,5562,630,101,493,36,491
Epping Forest 007,E02004533,7156,6575,581,101,451,29,447
Epping Forest 008,E02004534,8758,7927,831,127,654,50,602
Epping Forest 009,E02004535,5235,4730,505,44,432,29,434
Epping Forest 010,E02004536,6075,5637,438,64,351,23,414
Epping Forest 011,E02004537,8550,7738,812,112,658,42,693
Epping Forest 012,E02004538,8971,8016,955,88,798,69,775
Epping Forest 013,E02004539,7612,6943,669,61,570,38,579
Epping Forest 014,E02004540,5973,5458,515,37,427,51,513
Epping Forest 015,E02004541,11380,10113,1267,188,987,92,920
Epping Forest 016,E02004542,6367,5869,498,77,377,44,469
Epping Forest 017,E02004543,6620,5969,651,54,549,48,574
Harlow 001,E02004544,6968,6271,697,73,584,40,516
Harlow 002,E02004545,7184,6386,798,89,647,62,631
Harlow 003,E02004546,7423,6609,814,118,624,72,692
Harlow 004,E02004547,7957,6946,1011,126,771,114,763
Harlow 005,E02004548,8895,8032,863,205,634,24,751
Harlow 006,E02004549,7694,7043,651,68,553,30,631
Harlow 007,E02004550,7662,6716,946,108,720,118,664
Harlow 008,E02004551,7206,6574,632,82,536,14,569
Harlow 009,E02004552,6455,5954,501,68,398,35,545
Harlow 010,E02004553,7270,6567,703,81,578,44,612
Harlow 011,E02004554,7230,6504,726,80,587,59,686
Maldon 001,E02004555,6042,5616,426,95,302,29,301
Maldon 002,E02004556,7160,6713,447,35,380,32,492
Maldon 003,E02004557,8175,7440,735,119,587,29,609
Maldon 004,E02004558,6428,5729,699,110,563,26,516
Maldon 005,E02004559,7792,7242,550,101,437,12,527
Maldon 006,E02004560,8332,7619,713,186,508,19,424
Maldon 007,E02004561,10029,9348,681,99,535,47,576
Maldon 008,E02004562,7671,6958,713,256,417,40,450
Rochford 001,E02004563,6527,6125,402,74,321,7,286
Rochford 002,E02004564,7969,7477,492,55,424,13,413
Rochford 003,E02004565,14876,13920,956,239,667,50,751
Rochford 004,E02004566,5725,5118,607,101,488,18,431
Rochford 005,E02004567,8151,7543,608,32,546,30,549
Rochford 006,E02004568,8543,7872,671,96,544,31,630
Rochford 007,E02004569,7300,6652,648,78,548,22,591
Rochford 008,E02004570,8683,7887,796,110,623,63,590
Rochford 009,E02004571,7899,7399,500,37,436,27,492
Rochford 010,E02004572,7614,7148,466,96,362,8,403
Tendring 001,E02004573,6072,5188,884,280,566,38,503
Tendring 002,E02004574,7312,6531,781,203,555,23,537
Tendring 003,E02004575,11138,10147,991,264,696,31,756
Tendring 004,E02004576,8831,8148,683,145,506,32,534
Tendring 005,E02004577,5203,4810,393,45,335,13,381
Tendring 006,E02004578,7149,6142,1007,248,714,45,542
Tendring 007,E02004579,6890,6409,481,66,397,18,497
Tendring 008,E02004580,11696,10632,1064,259,763,42,713
Tendring 009,E02004581,7410,6824,586,116,440,30,473
Tendring 010,E02004582,6689,6179,510,35,461,14,481
Tendring 011,E02004583,8299,7493,806,273,501,32,486
Tendring 012,E02004584,6441,5955,486,57,418,11,378
Tendring 013,E02004585,7652,6986,666,83,573,10,509
Tendring 014,E02004586,8145,7172,973,117,814,42,762
Tendring 015,E02004587,7744,6941,803,114,676,13,691
Tendring 016,E02004588,6475,5455,1020,197,779,44,676
Tendring 017,E02004589,7402,6589,813,114,665,34,592
Tendring 018,E02004590,7500,6737,763,162,573,28,574
Uttlesford 001,E02004591,6847,6197,650,156,460,34,606
Uttlesford 002,E02004592,12102,10663,1439,393,926,120,751
Uttlesford 003,E02004593,8132,7398,734,140,548,46,580
Uttlesford 004,E02004594,7819,6958,861,151,652,58,768
Uttlesford 005,E02004595,11911,10664,1247,264,927,56,824
Uttlesford 006,E02004596,7662,6604,1058,110,892,56,617
Uttlesford 007,E02004597,7267,6512,755,176,533,46,507
Uttlesford 008,E02004598,10349,9243,1106,173,826,107,802
Uttlesford 009,E02004599,7354,6739,615,73,509,33,559
Broxbourne 001,E02004843,7181,6672,509,63,417,29,451
Broxbourne 002,E02004844,7187,6562,625,92,496,37,488
Broxbourne 003,E02004845,7240,6381,859,100,718,41,602
Broxbourne 004,E02004846,6238,5757,481,80,375,26,431
Broxbourne 005,E02004847,9763,8747,1016,103,877,36,758
Broxbourne 006,E02004848,7192,6684,508,32,464,12,568
Broxbourne 007,E02004849,6836,6405,431,32,365,34,470
Broxbourne 008,E02004850,7446,6861,585,29,538,18,536
Broxbourne 009,E02004851,5800,5396,404,20,372,12,381
Broxbourne 010,E02004852,7646,7039,607,47,534,26,535
Broxbourne 011,E02004853,6336,5912,424,42,372,10,410
Broxbourne 012,E02004854,7337,6669,668,49,572,47,535
Broxbourne 013,E02004855,7407,6591,816,120,624,72,618
Dacorum 001,E02004856,5413,4860,553,90,423,40,419
Dacorum 002,E02004857,5663,5055,608,100,462,46,512
Dacorum 003,E02004858,5078,4616,462,71,349,42,378
Dacorum 004,E02004859,5195,4783,412,57,334,21,415
Dacorum 005,E02004860,5765,4996,769,90,620,59,550
Dacorum 006,E02004861,5484,4903,581,67,465,49,424
Dacorum 007,E02004862,7574,6838,736,99,567,70,593
Dacorum 008,E02004863,7764,6848,916,116,741,59,682
Dacorum 009,E02004864,6282,5514,768,93,621,54,603
Dacorum 010,E02004865,5332,4762,570,47,494,29,526
Dacorum 011,E02004866,6577,6060,517,50,448,19,507
Dacorum 012,E02004867,6083,5440,643,52,543,48,514
Dacorum 013,E02004868,5848,5171,677,68,584,25,506
Dacorum 014,E02004869,5650,5032,618,58,508,52,569
Dacorum 015,E02004870,9390,8047,1343,107,1127,109,872
Dacorum 016,E02004871,5068,4646,422,34,358,30,363
Dacorum 017,E02004872,6961,6419,542,68,442,32,535
Dacorum 018,E02004873,10069,8714,1355,166,1111,78,1024
Dacorum 019,E02004874,6183,5635,548,36,483,29,536
Dacorum 020,E02004875,9255,8388,867,128,681,58,695
Dacorum 021,E02004876,8999,7977,1022,163,794,65,813
Dacorum 022,E02004877,5214,4699,515,88,406,21,371
East Hertfordshire 001,E02004878,6715,6171,544,124,402,18,400
East Hertfordshire 002,E02004879,7720,7131,589,55,521,13,568
East Hertfordshire 003,E02004880,9178,8351,827,113,643,71,752
East Hertfordshire 004,E02004881,5698,5002,696,66,573,57,576
East Hertfordshire 005,E02004882,8000,6984,1016,104,760,152,750
East Hertfordshire 006,E02004883,5741,5277,464,63,359,42,428
East Hertfordshire 007,E02004884,9829,8666,1163,165,872,126,901
East Hertfordshire 008,E02004885,8804,8028,776,125,595,56,782
East Hertfordshire 009,E02004886,5633,5125,508,85,388,35,439
East Hertfordshire 010,E02004887,7129,6529,600,79,484,37,569
East Hertfordshire 011,E02004888,8458,7596,862,154,687,21,632
East Hertfordshire 012,E02004889,10528,9343,1185,231,898,56,873
East Hertfordshire 013,E02004890,8271,7324,947,131,770,46,800
East Hertfordshire 014,E02004891,7456,6628,828,106,683,39,690
East Hertfordshire 015,E02004892,5564,4998,566,90,457,19,464
East Hertfordshire 016,E02004893,5453,4931,522,71,425,26,470
East Hertfordshire 017,E02004894,8310,7035,1275,174,1027,74,929
East Hertfordshire 018,E02004895,9200,8314,886,82,706,98,750
Hertsmere 001,E02004896,7875,7044,831,97,672,62,603
Hertsmere 002,E02004897,6663,6123,540,31,481,28,531
Hertsmere 003,E02004898,7344,6677,667,53,577,37,678
Hertsmere 004,E02004899,5506,4939,567,63,465,39,464
Hertsmere 005,E02004900,8163,7349,814,182,559,73,735
Hertsmere 006,E02004901,8439,7634,805,101,644,60,680
Hertsmere 007,E02004902,7928,7061,867,135,631,101,620
Hertsmere 008,E02004903,6727,5979,748,44,651,53,545
Hertsmere 009,E02004904,5906,5310,596,64,493,39,523
Hertsmere 010,E02004905,6762,6117,645,58,517,70,577
Hertsmere 011,E02004906,9682,8685,997,126,794,77,772
Hertsmere 012,E02004907,9263,8274,989,123,758,108,715
Hertsmere 013,E02004908,9773,8855,918,144,680,94,838
North Hertfordshire 001,E02004909,5119,4618,501,65,406,30,461
North Hertfordshire 002,E02004910,10662,9600,1062,343,649,70,807
North Hertfordshire 003,E02004911,6538,6070,468,60,397,11,364
North Hertfordshire 004,E02004912,10280,9189,1091,277,769,45,632
North Hertfordshire 005,E02004913,14741,13141,1600,214,1265,121,1377
North Hertfordshire 006,E02004914,7373,6484,889,71,773,45,657
North Hertfordshire 007,E02004915,5411,4806,605,95,481,29,481
North Hertfordshire 008,E02004916,7337,6645,692,70,564,58,565
North Hertfordshire 009,E02004917,6590,6044,546,70,449,27,460
North Hertfordshire 010,E02004918,8097,6815,1282,168,1049,65,836
North Hertfordshire 011,E02004919,7288,6648,640,72,525,43,603
North Hertfordshire 012,E02004920,10654,9475,1179,184,902,93,915
North Hertfordshire 013,E02004921,7562,6767,795,102,651,42,669
North Hertfordshire 014,E02004922,9455,8628,827,130,632,65,683
North Hertfordshire 015,E02004923,10007,9071,936,201,666,69,831
St Albans 001,E02004924,7239,6465,774,154,551,69,577
St Albans 002,E02004925,7691,6784,907,132,680,95,751
St Albans 003,E02004926,7743,6540,1203,223,898,82,865
St Albans 004,E02004927,6410,5819,591,87,461,43,460
St Albans 005,E02004928,6775,6153,622,73,483,66,597
St Albans 006,E02004929,6226,5655,571,73,468,30,515
St Albans 007,E02004930,6826,6188,638,76,528,34,576
St Albans 008,E02004931,6497,5905,592,52,497,43,555
St Albans 009,E02004932,7703,6906,797,56,705,36,705
St Albans 010,E02004933,6907,6204,703,50,598,55,702
St Albans 011,E02004934,7158,5932,1226,68,1046,112,933
St Albans 012,E02004935,7602,5960,1642,205,1295,142,1271
St Albans 013,E02004936,6178,5434,744,59,604,81,660
St Albans 014,E02004937,6404,5736,668,67,537,64,606
St Albans 015,E02004938,5962,5350,612,34,534,44,463
St Albans 016,E02004939,6614,5870,744,50,635,59,657
St Albans 017,E02004940,7357,6511,846,58,716,72,738
St Albans 018,E02004941,9507,8491,1016,174,748,94,798
St Albans 019,E02004942,6130,5550,580,60,490,30,469
St Albans 020,E02004943,7735,7134,601,77,491,33,528
Stevenage 001,E02004944,6746,5869,877,81,760,36,565
Stevenage 002,E02004945,11794,10369,1425,139,1184,102,1133
Stevenage 003,E02004946,6329,5757,572,34,518,20,620
Stevenage 004,E02004947,6326,5781,545,48,470,27,541
Stevenage 005,E02004948,5795,5111,684,90,532,62,617
Stevenage 006,E02004949,8000,7042,958,96,805,57,668
Stevenage 007,E02004950,6779,6227,552,50,474,28,474
Stevenage 008,E02004951,7015,6298,717,91,572,54,589
Stevenage 009,E02004952,6658,6041,617,47,551,19,568
Stevenage 010,E02004953,6210,5646,564,28,516,20,486
Stevenage 011,E02004954,6395,5711,684,55,581,48,641
Stevenage 012,E02004955,5910,5477,433,25,389,19,356
Three Rivers 001,E02004956,8815,8011,804,67,688,49,743
Three Rivers 002,E02004957,8732,7965,767,90,634,43,737
Three Rivers 003,E02004958,7197,6631,566,41,484,41,569
Three Rivers 004,E02004959,5808,5137,671,58,524,89,561
Three Rivers 005,E02004960,5567,5003,564,94,429,41,436
Three Rivers 006,E02004961,9241,8466,775,183,539,53,599
Three Rivers 007,E02004962,8521,7684,837,114,654,69,717
Three Rivers 008,E02004963,7029,6512,517,78,403,36,484
Three Rivers 009,E02004964,5602,5081,521,81,412,28,462
Three Rivers 010,E02004965,6532,6039,493,59,382,52,441
Three Rivers 011,E02004966,6967,6131,836,96,606,134,642
Three Rivers 012,E02004967,7306,6643,663,103,503,57,519
Watford 001,E02004968,7083,6396,687,42,615,30,561
Watford 002,E02004969,7195,6655,540,40,464,36,635
Watford 003,E02004970,7832,6983,849,94,705,50,487
Watford 004,E02004971,7484,6751,733,52,618,63,645
Watford 005,E02004972,6100,5416,684,52,576,56,566
Watford 006,E02004973,7444,6288,1156,155,883,118,905
Watford 007,E02004974,7606,6490,1116,109,938,69,819
Watford 008,E02004975,7778,6876,902,63,784,55,762
Watford 009,E02004976,8143,6270,1873,289,1408,176,1297
Watford 010,E02004977,8258,6903,1355,205,959,191,968
Watford 011,E02004978,8626,7417,1209,164,921,124,950
Watford 012,E02004979,6752,6048,704,51,599,54,595
Welwyn Hatfield 001,E02004980,5995,5511,484,53,395,36,396
Welwyn Hatfield 002,E02004981,7189,6429,760,91,606,63,681
Welwyn Hatfield 003,E02004982,5923,5459,464,43,402,19,412
Welwyn Hatfield 004,E02004983,5964,5420,544,55,459,30,469
Welwyn Hatfield 005,E02004984,6314,5689,625,70,512,43,559
Welwyn Hatfield 006,E02004985,6806,6212,594,92,449,53,428
Welwyn Hatfield 007,E02004986,7431,6602,829,116,656,57,762
Welwyn Hatfield 008,E02004987,6740,6122,618,54,509,55,619
Welwyn Hatfield 009,E02004988,7441,6623,818,82,668,68,750
Welwyn Hatfield 010,E02004989,12612,7893,4719,538,3324,857,2043
Welwyn Hatfield 011,E02004990,6371,5247,1124,98,891,135,885
Welwyn Hatfield 012,E02004991,7324,5422,1902,188,1482,232,1100
Welwyn Hatfield 013,E02004992,8119,5635,2484,588,1642,254,1566
Welwyn Hatfield 014,E02004993,5251,4470,781,67,643,71,572
Welwyn Hatfield 015,E02004994,5874,5350,524,55,420,49,491
Welwyn Hatfield 016,E02004995,5181,4805,376,44,302,30,465
Breckland 001,E02005503,7111,6297,814,118,650,46,628
Breckland 002,E02005504,8735,7987,748,132,574,42,566
Breckland 003,E02005505,7184,6445,739,136,573,30,574
Breckland 004,E02005506,6849,6237,612,82,495,35,501
Breckland 005,E02005507,11425,9998,1427,429,957,41,931
Breckland 006,E02005508,6640,6089,551,68,452,31,452
Breckland 007,E02005509,7258,6349,909,283,590,36,459
Breckland 008,E02005510,6641,6058,583,104,454,25,475
Breckland 009,E02005511,7202,6270,932,241,600,91,551
Breckland 010,E02005512,8810,7506,1304,98,1120,86,878
Breckland 011,E02005513,9009,8002,1007,380,561,66,590
Breckland 012,E02005514,6554,5854,700,99,483,118,506
Breckland 013,E02005515,6223,5662,561,87,454,20,486
Breckland 014,E02005516,6510,5792,718,137,528,53,471
Breckland 015,E02005517,5910,5120,790,152,536,102,639
Breckland 016,E02005518,10635,9100,1535,422,892,221,924
Breckland 017,E02005519,7795,6888,907,212,531,164,736
Broadland 001,E02005520,7378,6767,611,209,396,6,420
Broadland 002,E02005521,8519,7688,831,180,625,26,588
Broadland 003,E02005522,5302,4798,504,81,406,17,313
Broadland 004,E02005523,7737,7082,655,88,559,8,528
Broadland 005,E02005524,5442,5051,391,70,308,13,387
Broadland 006,E02005525,10142,9244,898,185,676,37,632
Broadland 007,E02005526,5489,4928,561,60,474,27,419
Broadland 008,E02005527,8229,7533,696,92,582,22,514
Broadland 009,E02005528,8458,7759,699,82,589,28,645
Broadland 010,E02005529,5807,5410,397,39,353,5,360
Broadland 011,E02005530,5150,4756,394,24,356,14,342
Broadland 012,E02005531,5483,5032,451,30,399,22,446
Broadland 013,E02005532,6858,6436,422,48,352,22,428
Broadland 014,E02005533,8237,7642,595,76,503,16,489
Broadland 015,E02005534,7296,6768,528,39,449,40,479
Broadland 016,E02005535,7260,6354,906,139,723,44,724
Broadland 017,E02005536,5790,5222,568,95,450,23,367
Broadland 018,E02005537,6069,5528,541,162,365,14,386
Great Yarmouth 001,E02005538,9118,8431,687,149,516,22,590
Great Yarmouth 002,E02005539,7544,6867,677,123,537,17,428
Great Yarmouth 003,E02005540,9076,8196,880,251,608,21,466
Great Yarmouth 004,E02005541,6078,5352,726,123,579,24,677
Great Yarmouth 005,E02005542,6866,5642,1224,218,923,83,879
Great Yarmouth 006,E02005543,8681,7177,1504,475,895,134,1132
Great Yarmouth 007,E02005544,7134,6069,1065,209,814,42,898
Great Yarmouth 008,E02005545,6448,5963,485,72,397,16,420
Great Yarmouth 009,E02005546,7888,6968,920,152,760,8,711
Great Yarmouth 010,E02005547,9003,7770,1233,263,917,53,825
Great Yarmouth 011,E02005548,7256,6566,690,93,568,29,582
Great Yarmouth 012,E02005549,5479,5059,420,91,306,23,462
Great Yarmouth 013,E02005550,6706,6127,579,83,479,17,439
King's Lynn and West Norfolk 001,E02005551,5420,4649,771,175,565,31,391
King's Lynn and West Norfolk 002,E02005552,7072,6277,795,155,601,39,549
King's Lynn and West Norfolk 003,E02005553,8782,7902,880,242,611,27,491
King's Lynn and West Norfolk 004,E02005554,6896,6287,609,147,429,33,356
King's Lynn and West Norfolk 005,E02005555,6908,6407,501,85,394,22,423
King's Lynn and West Norfolk 006,E02005556,7681,7140,541,79,437,25,567
King's Lynn and West Norfolk 007,E02005557,6072,5280,792,172,562,58,582
King's Lynn and West Norfolk 008,E02005558,6869,6345,524,133,369,22,408
King's Lynn and West Norfolk 009,E02005559,7022,6240,782,90,620,72,636
King's Lynn and West Norfolk 010,E02005560,8506,7325,1181,211,845,125,797
King's Lynn and West Norfolk 011,E02005561,9832,8189,1643,427,1059,157,1116
King's Lynn and West Norfolk 012,E02005562,7008,6435,573,119,419,35,394
King's Lynn and West Norfolk 013,E02005563,7448,6937,511,71,414,26,473
King's Lynn and West Norfolk 014,E02005564,10270,8729,1541,191,1270,80,1264
King's Lynn and West Norfolk 015,E02005565,7024,6439,585,111,439,35,483
King's Lynn and West Norfolk 016,E02005566,9527,8715,812,172,605,35,660
King's Lynn and West Norfolk 017,E02005567,9994,8678,1316,308,958,50,655
King's Lynn and West Norfolk 018,E02005568,7189,6635,554,94,421,39,468
King's Lynn and West Norfolk 019,E02005569,7931,7143,788,123,492,173,412
North Norfolk 001,E02005570,7367,6548,819,252,539,28,397
North Norfolk 002,E02005571,5952,5365,587,144,404,39,373
North Norfolk 003,E02005572,7683,6650,1033,352,656,25,495
North Norfolk 004,E02005573,5704,5000,704,139,486,79,382
North Norfolk 005,E02005574,6757,6015,742,109,600,33,497
North Norfolk 006,E02005575,6981,6431,550,76,434,40,525
North Norfolk 007,E02005576,6647,6047,600,119,456,25,403
North Norfolk 008,E02005577,5948,5366,582,147,400,35,492
North Norfolk 009,E02005578,5728,5089,639,124,490,25,441
North Norfolk 010,E02005579,12634,11454,1180,412,723,45,749
North Norfolk 011,E02005580,7617,6842,775,275,475,25,469
North Norfolk 012,E02005581,7704,6614,1090,91,944,55,532
North Norfolk 013,E02005582,6502,5805,697,184,497,16,380
North Norfolk 014,E02005583,8275,7567,708,115,550,43,550
Norwich 001,E02005584,10596,9068,1528,181,1262,85,1422
Norwich 002,E02005585,10655,9118,1537,231,1214,92,1237
Norwich 003,E02005586,9934,8070,1864,219,1526,119,1380
Norwich 004,E02005587,9855,8793,1062,116,918,28,846
Norwich 005,E02005588,11683,9637,2046,322,1508,216,1387
Norwich 006,E02005589,11504,9555,1949,198,1601,150,1630
Norwich 007,E02005590,9641,7386,2255,209,1817,229,1803
Norwich 009,E02005592,9297,6624,2673,397,2069,207,1954
Norwich 010,E02005593,10279,6232,4047,424,2788,835,2554
Norwich 011,E02005594,10404,8023,2381,237,1916,228,1847
Norwich 012,E02005595,8781,7696,1085,104,884,97,947
Norwich 013,E02005596,9326,8219,1107,148,890,69,932
Norwich 014,E02006907,5136,3592,1544,100,1288,156,1158
Norwich 015,E02006908,5421,4285,1136,68,971,97,927
South Norfolk 001,E02005597,12463,10812,1651,318,1283,50,783
South Norfolk 002,E02005598,7769,6845,924,96,781,47,740
South Norfolk 003,E02005599,5691,5215,476,96,355,25,399
South Norfolk 004,E02005600,6216,5504,712,86,575,51,531
South Norfolk 005,E02005601,5714,5136,578,83,469,26,407
South Norfolk 006,E02005602,10355,9486,869,181,652,36,645
South Norfolk 007,E02005603,8691,7751,940,192,699,49,616
South Norfolk 008,E02005604,8200,7502,698,179,472,47,514
South Norfolk 009,E02005605,10178,9244,934,161,739,34,700
South Norfolk 010,E02005606,5597,5108,489,84,391,14,423
South Norfolk 011,E02005607,10957,9993,964,217,708,39,633
South Norfolk 012,E02005608,7337,6675,662,114,534,14,511
South Norfolk 013,E02005609,6841,6162,679,163,484,32,384
South Norfolk 014,E02005610,7981,7311,670,87,546,37,555
South Norfolk 015,E02005611,10022,8890,1132,387,672,73,691
Babergh 001,E02006227,6065,5395,670,118,518,34,474
Babergh 002,E02006228,5758,5241,517,119,382,16,397
Babergh 003,E02006229,5667,5111,556,77,447,32,412
Babergh 004,E02006230,10444,9311,1133,371,702,60,733
Babergh 005,E02006231,8350,7566,784,97,651,36,706
Babergh 006,E02006232,5674,5251,423,41,364,18,371
Babergh 007,E02006233,11170,9862,1308,389,848,71,880
Babergh 008,E02006234,8908,7902,1006,277,701,28,516
Babergh 009,E02006235,7937,7232,705,139,525,41,556
Babergh 010,E02006236,10041,9286,755,209,502,44,619
Babergh 011,E02006237,7726,6979,747,183,491,73,501
Forest Heath 001,E02006238,9636,8392,1244,370,628,246,495
Forest Heath 002,E02006239,6558,5300,1258,145,434,679,412
Forest Heath 003,E02006240,8680,6995,1685,210,867,608,592
Forest Heath 004,E02006241,8688,7325,1363,308,661,394,530
Forest Heath 005,E02006242,7611,6192,1419,135,841,443,609
Forest Heath 006,E02006243,8996,7667,1329,259,921,149,828
Forest Heath 008,E02006826,9579,7914,1665,302,1127,236,960
Ipswich 001,E02006245,8039,7521,518,60,434,24,502
Ipswich 002,E02006246,7463,6967,496,50,426,20,478
Ipswich 003,E02006247,8879,7804,1075,176,838,61,830
Ipswich 004,E02006248,8324,7609,715,94,587,34,550
Ipswich 005,E02006249,7876,6797,1079,110,870,99,805
Ipswich 006,E02006250,9938,7657,2281,374,1639,268,1294
Ipswich 007,E02006251,9700,7255,2445,299,1899,247,1424
Ipswich 008,E02006252,9134,7982,1152,129,960,63,915
Ipswich 009,E02006253,7055,6456,599,64,514,21,586
Ipswich 010,E02006254,8826,7642,1184,122,954,108,1070
Ipswich 011,E02006255,7799,6424,1375,156,1027,192,1026
Ipswich 012,E02006256,8632,7272,1360,215,1050,95,946
Ipswich 013,E02006257,6660,6200,460,67,388,5,419
Ipswich 014,E02006258,8991,7814,1177,159,952,66,978
Ipswich 015,E02006259,7276,6439,837,104,687,46,642
Ipswich 016,E02006260,8792,8003,789,129,631,29,646
Mid Suffolk 001,E02006261,7689,6881,808,185,592,31,565
Mid Suffolk 002,E02006262,8659,7868,791,174,589,28,572
Mid Suffolk 003,E02006263,7278,6680,598,104,464,30,497
Mid Suffolk 004,E02006264,8156,7405,751,106,613,32,689
Mid Suffolk 005,E02006265,6956,6358,598,84,490,24,464
Mid Suffolk 006,E02006266,9129,8365,764,93,619,52,718
Mid Suffolk 007,E02006267,8381,7672,709,118,553,38,530
Mid Suffolk 008,E02006268,6278,5659,619,96,511,12,546
Mid Suffolk 009,E02006269,6946,6266,680,83,574,23,581
Mid Suffolk 010,E02006270,11366,9815,1551,401,1087,63,893
Mid Suffolk 011,E02006271,8492,7419,1073,122,871,80,877
Mid Suffolk 012,E02006272,7401,6692,709,144,541,24,529
St Edmundsbury 001,E02006273,6330,5742,588,76,476,36,499
St Edmundsbury 002,E02006274,7197,6100,1097,120,898,79,953
St Edmundsbury 003,E02006275,7201,6459,742,146,570,26,580
St Edmundsbury 004,E02006276,6562,5973,589,47,517,25,398
St Edmundsbury 005,E02006277,7968,6812,1156,222,798,136,766
St Edmundsbury 006,E02006278,8428,6850,1578,217,1161,200,1020
St Edmundsbury 007,E02006279,9053,8169,884,113,710,61,707
St Edmundsbury 008,E02006280,9308,8482,826,106,632,88,648
St Edmundsbury 009,E02006281,8463,7410,1053,85,862,106,706
St Edmundsbury 010,E02006282,6204,5646,558,77,443,38,446
St Edmundsbury 011,E02006283,7253,6233,1020,101,863,56,719
St Edmundsbury 012,E02006284,7796,7038,758,160,562,36,602
St Edmundsbury 013,E02006285,7974,7277,697,136,527,34,580
St Edmundsbury 014,E02006286,11271,10045,1226,393,740,93,729
Suffolk Coastal 001,E02006287,5943,5370,573,93,453,27,371
Suffolk Coastal 002,E02006288,8865,7918,947,270,599,78,601
Suffolk Coastal 003,E02006289,8273,7417,856,215,599,42,576
Suffolk Coastal 004,E02006290,8136,7259,877,317,500,60,462
Suffolk Coastal 005,E02006291,7039,6390,649,115,489,45,517
Suffolk Coastal 006,E02006292,6543,6021,522,67,425,30,488
Suffolk Coastal 007,E02006293,10705,9129,1576,290,1201,85,985
Suffolk Coastal 008,E02006294,8096,7161,935,202,671,62,640
Suffolk Coastal 009,E02006295,9295,8565,730,99,588,43,586
Suffolk Coastal 010,E02006296,12773,11486,1287,271,936,80,1069
Suffolk Coastal 011,E02006297,8018,7384,634,73,530,31,606
Suffolk Coastal 012,E02006298,8865,8129,736,147,560,29,535
Suffolk Coastal 013,E02006299,8344,7716,628,84,512,32,471
Suffolk Coastal 014,E02006300,7507,6676,831,261,557,13,552
Suffolk Coastal 015,E02006301,5896,5112,784,130,596,58,573
Waveney 001,E02006302,6968,6189,779,104,657,18,599
Waveney 002,E02006303,7649,6977,672,109,542,21,580
Waveney 003,E02006304,7468,6972,496,54,428,14,478
Waveney 004,E02006305,9224,7886,1338,400,893,45,904
Waveney 005,E02006306,7217,6538,679,73,588,18,641
Waveney 006,E02006307,7382,6888,494,66,411,17,428
Waveney 007,E02006308,7198,5988,1210,218,945,47,930
Waveney 008,E02006309,6800,6151,649,98,534,17,481
Waveney 009,E02006310,8079,7312,767,130,616,21,566
Waveney 010,E02006311,8219,7367,852,224,604,24,580
Waveney 011,E02006312,8762,8048,714,139,545,30,580
Waveney 012,E02006313,10139,9269,870,173,665,32,762
Waveney 013,E02006314,7369,6624,745,241,475,29,500
Waveney 014,E02006315,5904,5237,667,157,470,40,352
Waveney 015,E02006316,6876,6173,703,253,435,15,469
Camden 001,E02000166,7924,6856,1068,89,847,132,904
Camden 002,E02000167,7944,6471,1473,148,974,351,1129
Camden 003,E02000168,8172,6922,1250,79,1043,128,1029
Camden 004,E02000169,7637,5871,1766,116,1149,501,1255
Camden 005,E02000170,8338,6583,1755,72,1376,307,1477
Camden 006,E02000171,7818,6504,1314,79,1001,234,1064
Camden 007,E02000172,10147,8440,1707,96,1320,291,1395
Camden 008,E02000173,7675,5828,1847,96,1227,524,1332
Camden 009,E02000174,8714,7345,1369,75,1052,242,1199
Camden 010,E02000175,8848,6755,2093,125,1533,435,1667
Camden 011,E02000176,6373,4975,1398,93,924,381,945
Camden 012,E02000177,8948,7464,1484,70,1179,235,1178
Camden 013,E02000178,8857,6948,1909,83,1543,283,1631
Camden 014,E02000179,6329,5047,1282,72,964,246,848
Camden 015,E02000180,8202,6132,2070,118,1493,459,1649
Camden 016,E02000181,7708,5904,1804,160,1318,326,1539
Camden 017,E02000182,6697,5341,1356,66,875,415,1020
Camden 018,E02000183,7913,6541,1372,111,932,329,1031
Camden 019,E02000184,8882,6953,1929,40,1548,341,1530
Camden 020,E02000185,8290,6933,1357,57,1050,250,1293
Camden 021,E02000186,6687,5066,1621,55,1221,345,1278
Camden 022,E02000187,8155,6808,1347,82,1047,218,1089
Camden 023,E02000188,8322,6343,1979,94,1590,295,1361
Camden 024,E02000189,5944,4474,1470,32,1047,391,1125
Camden 025,E02000190,7530,4825,2705,117,1637,951,1934
Camden 026,E02000191,7497,4202,3295,133,2323,839,2267
Camden 027,E02000192,7157,5946,1211,62,940,209,846
Camden 028,E02000193,7630,5471,2159,77,1551,531,1304
City of London 001,E02000001,7375,5640,1735,178,1189,368,1204
Hackney 001,E02000345,8838,7825,1013,157,711,145,840
Hackney 002,E02000346,6092,5200,892,144,602,146,767
Hackney 003,E02000347,7956,7075,881,108,649,124,802
Hackney 004,E02000348,8120,7226,894,64,736,94,915
Hackney 006,E02000350,9502,7902,1600,89,1352,159,1372
Hackney 007,E02000351,8523,6342,2181,107,1811,263,1676
Hackney 008,E02000352,6883,5787,1096,60,957,79,803
Hackney 009,E02000353,7786,6276,1510,90,1264,156,1264
Hackney 010,E02000354,9502,7913,1589,54,1367,168,1322
Hackney 011,E02000355,8485,6948,1537,135,1231,171,1145
Hackney 012,E02000356,7346,6032,1314,68,1118,128,1031
Hackney 013,E02000357,6339,5725,614,56,478,80,656
Hackney 014,E02000358,11058,8952,2106,122,1766,218,1744
Hackney 015,E02000359,6581,5545,1036,38,891,107,860
Hackney 016,E02000360,11292,9703,1589,87,1368,134,1400
Hackney 017,E02000361,7640,6118,1522,48,1324,150,1193
Hackney 018,E02000362,6363,5356,1007,37,862,108,769
Hackney 019,E02000363,10845,9411,1434,189,1110,135,1283
Hackney 020,E02000364,8867,7071,1796,54,1601,141,1248
Hackney 021,E02000365,12764,10037,2727,142,2212,373,2045
Hackney 022,E02000366,8514,7173,1341,72,1109,160,1045
Hackney 023,E02000367,9741,7797,1944,100,1583,261,1514
Hackney 024,E02000368,9614,8141,1473,78,1190,205,1098
Hackney 025,E02000369,11594,9722,1872,97,1517,258,1521
Hackney 026,E02000370,8301,6913,1388,57,1060,271,1021
Hackney 027,E02000371,12369,8686,3683,184,2647,852,2669
Hackney 028,E02006918,7611,6305,1306,73,1100,133,797
Hackney 029,E02006921,7744,6878,866,42,692,132,715
Hammersmith and Fulham 001,E02000372,9175,7384,1791,141,1267,383,1240
Hammersmith and Fulham 002,E02000373,6658,5762,896,103,660,133,742
Hammersmith and Fulham 003,E02000374,6731,5527,1204,50,942,212,970
Hammersmith and Fulham 004,E02000375,7028,5619,1409,55,1087,267,1237
Hammersmith and Fulham 005,E02000376,6915,5258,1657,66,1220,371,1302
Hammersmith and Fulham 006,E02000377,8169,6422,1747,52,1326,369,1334
Hammersmith and Fulham 007,E02000378,6534,5072,1462,53,1060,349,1183
Hammersmith and Fulham 008,E02000379,7581,5859,1722,69,1310,343,1040
Hammersmith and Fulham 009,E02000380,5863,4687,1176,41,935,200,929
Hammersmith and Fulham 010,E02000381,7768,6002,1766,106,1327,333,1412
Hammersmith and Fulham 011,E02000382,6167,4939,1228,65,980,183,1107
Hammersmith and Fulham 012,E02000383,9432,6950,2482,150,1756,576,1639
Hammersmith and Fulham 013,E02000384,7320,5802,1518,38,1222,258,1259
Hammersmith and Fulham 014,E02000385,6162,4341,1821,99,1350,372,1283
Hammersmith and Fulham 015,E02000386,8136,6501,1635,76,1181,378,1234
Hammersmith and Fulham 016,E02000387,6272,4725,1547,42,1204,301,1140
Hammersmith and Fulham 017,E02000388,8202,6228,1974,83,1481,410,1387
Hammersmith and Fulham 018,E02000389,8255,6311,1944,147,1393,404,1396
Hammersmith and Fulham 019,E02000390,6448,4877,1571,50,1230,291,1385
Hammersmith and Fulham 020,E02000391,7729,6167,1562,76,1143,343,1320
Hammersmith and Fulham 021,E02000392,9578,7362,2216,130,1654,432,1666
Hammersmith and Fulham 022,E02000393,6031,4419,1612,64,1208,340,1248
Hammersmith and Fulham 023,E02000394,7755,5855,1900,133,1377,390,1278
Hammersmith and Fulham 024,E02000395,5951,4667,1284,57,992,235,1008
Hammersmith and Fulham 025,E02000396,6633,5478,1155,46,907,202,1060
Haringey 001,E02000397,7815,6314,1501,85,1189,227,1108
Haringey 002,E02000398,7123,6051,1072,40,856,176,880
Haringey 004,E02000400,7668,6629,1039,42,861,136,945
Haringey 005,E02000401,6734,6068,666,27,581,58,653
Haringey 006,E02000402,6697,5939,758,26,644,88,705
Haringey 007,E02000403,7199,5613,1586,53,1286,247,1305
Haringey 008,E02000404,7315,6142,1173,38,944,191,1012
Haringey 009,E02000405,6548,5703,845,71,712,62,763
Haringey 010,E02000406,7025,5933,1092,34,871,187,1000
Haringey 011,E02000407,7312,6153,1159,54,876,229,1097
Haringey 012,E02000408,7612,6300,1312,25,1012,275,844
Haringey 013,E02000409,6527,5730,797,23,645,129,798
Haringey 014,E02000410,6693,5380,1313,142,1079,92,1058
Haringey 015,E02000411,7452,6024,1428,49,1016,363,1126
Haringey 016,E02000412,6914,5530,1384,40,1104,240,1138
Haringey 017,E02000413,7500,6304,1196,101,968,127,933
Haringey 018,E02000414,7171,5819,1352,66,1028,258,1109
Haringey 019,E02000415,6845,5595,1250,42,1000,208,1143
Haringey 020,E02000416,7490,6210,1280,79,1067,134,1061
Haringey 021,E02000417,6676,5454,1222,95,983,144,1016
Haringey 022,E02000418,5509,4843,666,34,555,77,770
Haringey 023,E02000419,8108,6105,2003,79,1615,309,1727
Haringey 024,E02000420,7432,6105,1327,64,1011,252,1150
Haringey 025,E02000421,7148,5909,1239,49,917,273,1040
Haringey 026,E02000422,7825,6373,1452,35,984,433,1048
Haringey 027,E02000423,6813,5227,1586,52,1183,351,1396
Haringey 028,E02000424,7198,5898,1300,78,1105,117,1027
Haringey 029,E02000425,7256,6422,834,91,532,211,799
Haringey 030,E02000426,6731,5500,1231,82,1043,106,880
Haringey 031,E02000427,6854,5198,1656,61,1289,306,1278
Haringey 032,E02000428,7022,5781,1241,37,1015,189,1026
Haringey 033,E02000429,6852,5530,1322,88,1068,166,1145
Haringey 034,E02000430,7417,5757,1660,103,1438,119,1223
Haringey 035,E02000431,6685,5023,1662,97,1350,215,1112
Haringey 036,E02000432,6454,5083,1371,69,1143,159,1156
Haringey 037,E02006794,7306,6246,1060,50,888,122,852
Islington 001,E02000554,9182,7808,1374,73,1170,131,1278
Islington 002,E02000555,9408,7921,1487,60,1244,183,1375
Islington 003,E02000556,10008,8038,1970,102,1694,174,1668
Islington 004,E02000557,8124,6777,1347,78,1122,147,1192
Islington 005,E02000558,8870,7598,1272,84,1040,148,1181
Islington 006,E02000559,8778,6771,2007,120,1677,210,1495
Islington 007,E02000560,7076,5201,1875,61,1526,288,1531
Islington 008,E02000561,7746,6157,1589,62,1213,314,1410
Islington 009,E02000562,7934,6531,1403,55,1122,226,1223
Islington 010,E02000563,8486,6726,1760,76,1468,216,1438
Islington 011,E02000564,10488,8030,2458,158,1909,391,2014
Islington 012,E02000565,8187,6751,1436,54,1171,211,1190
Islington 013,E02000566,8164,6602,1562,78,1257,227,1315
Islington 014,E02000567,10358,8463,1895,71,1568,256,1653
Islington 015,E02000568,9625,7321,2304,123,1733,448,1631
Islington 016,E02000569,10022,8462,1560,59,1274,227,1481
Islington 017,E02000570,8615,6641,1974,75,1566,333,1373
Islington 018,E02000571,8031,6697,1334,88,1027,219,1073
Islington 019,E02000572,8571,6949,1622,78,1143,401,1193
Islington 020,E02000573,8674,6795,1879,79,1364,436,1710
Islington 021,E02000574,8501,6156,2345,81,1601,663,1744
Islington 022,E02000575,11889,8212,3677,211,2492,974,2478
Islington 023,E02000576,9388,7279,2109,102,1453,554,1373
Kensington and Chelsea 001,E02000577,7199,6371,828,109,600,119,645
Kensington and Chelsea 002,E02000578,5798,5147,651,52,498,101,459
Kensington and Chelsea 003,E02000579,8616,7355,1261,76,976,209,983
Kensington and Chelsea 004,E02000580,8655,7150,1505,87,1128,290,1130
Kensington and Chelsea 005,E02000581,7298,6515,783,66,586,131,727
Kensington and Chelsea 006,E02000582,7659,5879,1780,101,1173,506,1383
Kensington and Chelsea 007,E02000583,7303,5838,1465,105,992,368,1139
Kensington and Chelsea 008,E02000584,8178,6478,1700,89,1031,580,1147
Kensington and Chelsea 009,E02000585,8384,6736,1648,103,1071,474,1176
Kensington and Chelsea 010,E02000586,7769,5816,1953,121,1212,620,1361
Kensington and Chelsea 011,E02000587,7523,5891,1632,81,1000,551,1118
Kensington and Chelsea 012,E02000588,8159,6032,2127,151,1285,691,1090
Kensington and Chelsea 013,E02000589,8444,6099,2345,108,1575,662,1499
Kensington and Chelsea 014,E02000590,7015,5465,1550,100,925,525,994
Kensington and Chelsea 015,E02000591,6769,5367,1402,93,956,353,959
Kensington and Chelsea 016,E02000592,6761,5048,1713,124,1072,517,1331
Kensington and Chelsea 017,E02000593,7624,5837,1787,102,1146,539,1312
Kensington and Chelsea 018,E02000594,7252,5843,1409,99,926,384,990
Kensington and Chelsea 019,E02000595,7331,5804,1527,112,1020,395,1008
Kensington and Chelsea 020,E02000596,7782,5699,2083,119,1432,532,1510
Kensington and Chelsea 021,E02000597,7130,6027,1103,67,834,202,731
Lambeth 002,E02000619,8054,6721,1333,55,1093,185,1050
Lambeth 003,E02000620,9370,7516,1854,119,1535,200,1379
Lambeth 004,E02000621,10429,7653,2776,138,2262,376,1629
Lambeth 005,E02000622,8094,6430,1664,39,1385,240,1404
Lambeth 006,E02000623,7990,6847,1143,54,902,187,1018
Lambeth 007,E02000624,7976,6481,1495,73,1279,143,1175
Lambeth 008,E02000625,8361,6995,1366,60,1085,221,1272
Lambeth 009,E02000626,8301,7069,1232,48,1027,157,1059
Lambeth 010,E02000627,9571,6928,2643,89,2254,300,1663
Lambeth 011,E02000628,9731,8329,1402,120,1068,214,1253
Lambeth 012,E02000629,9033,6826,2207,82,1730,395,1787
Lambeth 013,E02000630,7266,5585,1681,68,1323,290,1373
Lambeth 014,E02000631,8832,7150,1682,97,1393,192,1402
Lambeth 015,E02000632,9516,6491,3025,145,2455,425,2342
Lambeth 016,E02000633,8642,7071,1571,72,1313,186,1400
Lambeth 017,E02000634,6846,5313,1533,46,1260,227,1189
Lambeth 018,E02000635,9157,7434,1723,114,1412,197,1488
Lambeth 019,E02000636,7639,5876,1763,84,1395,284,1596
Lambeth 020,E02000637,8687,6654,2033,156,1673,204,1639
Lambeth 021,E02000638,9898,7911,1987,85,1692,210,1654
Lambeth 022,E02000639,8119,6450,1669,348,1117,204,1069
Lambeth 023,E02000640,9123,7186,1937,94,1607,236,1699
Lambeth 024,E02000641,8779,7596,1183,73,962,148,1088
Lambeth 025,E02000642,9628,8085,1543,82,1283,178,1227
Lambeth 026,E02000643,8369,6695,1674,83,1382,209,1461
Lambeth 027,E02000644,8620,7030,1590,65,1370,155,1184
Lambeth 028,E02000645,9020,7417,1603,63,1366,174,1398
Lambeth 029,E02000646,9121,7148,1973,109,1669,195,1503
Lambeth 030,E02000647,8483,7271,1212,62,1000,150,990
Lambeth 031,E02000648,7791,6828,963,45,826,92,775
Lambeth 032,E02000649,11181,8803,2378,146,1951,281,1912
Lambeth 033,E02000650,7424,6401,1023,39,891,93,859
Lambeth 034,E02000651,8591,7227,1364,83,1118,163,1120
Lambeth 035,E02000652,7363,6450,913,84,653,176,864
Lambeth 036,E02006801,8081,5901,2180,148,1601,431,1649
Lewisham 001,E02000653,8544,7128,1416,86,1091,239,1132
Lewisham 002,E02000654,8059,6836,1223,76,989,158,849
Lewisham 003,E02000655,8208,6554,1654,138,1266,250,1376
Lewisham 005,E02000657,9078,6935,2143,166,1662,315,1797
Lewisham 006,E02000658,8314,6714,1600,68,1352,180,1202
Lewisham 007,E02000659,7697,6608,1089,45,925,119,991
Lewisham 008,E02000660,8078,6333,1745,105,1372,268,1360
Lewisham 009,E02000661,6342,5247,1095,58,879,158,993
Lewisham 010,E02000662,8100,6841,1259,49,1109,101,1051
Lewisham 011,E02000663,7194,6075,1119,56,917,146,958
Lewisham 012,E02000664,9928,7944,1984,71,1577,336,1431
Lewisham 013,E02000665,7916,6830,1086,54,891,141,940
Lewisham 014,E02000666,7321,6263,1058,63,888,107,880
Lewisham 015,E02000667,6534,5696,838,41,718,79,923
Lewisham 016,E02000668,6657,5836,821,59,689,73,785
Lewisham 017,E02000669,7518,6102,1416,89,1166,161,1005
Lewisham 018,E02000670,6539,5472,1067,57,923,87,823
Lewisham 019,E02000671,8403,7188,1215,72,1014,129,1168
Lewisham 020,E02000672,8377,7061,1316,59,1139,118,1047
Lewisham 021,E02000673,8007,6848,1159,71,996,92,974
Lewisham 022,E02000674,8015,7151,864,43,741,80,801
Lewisham 023,E02000675,8204,7345,859,47,730,82,781
Lewisham 024,E02000676,7713,6696,1017,41,879,97,953
Lewisham 025,E02000677,7199,6395,804,35,696,73,701
Lewisham 026,E02000678,6087,5540,547,18,489,40,555
Lewisham 027,E02000679,7905,6740,1165,41,1010,114,806
Lewisham 028,E02000680,6847,5774,1073,47,881,145,946
Lewisham 029,E02000681,8094,7433,661,32,558,71,747
Lewisham 030,E02000682,8162,7393,769,35,666,68,729
Lewisham 031,E02000683,6444,5739,705,38,609,58,669
Lewisham 033,E02000685,7679,6676,1003,39,871,93,866
Lewisham 034,E02000686,6681,5985,696,62,574,60,638
Lewisham 035,E02000687,7926,6858,1068,44,836,188,978
Lewisham 037,E02006783,7208,6613,595,40,501,54,684
Lewisham 038,E02006784,7359,6679,680,28,582,70,630
Lewisham 039,E02006798,7548,6102,1446,60,1170,216,1197
Newham 001,E02000714,8133,6949,1184,103,888,193,1026
Newham 002,E02000715,7381,6279,1102,69,763,270,897
Newham 003,E02000716,7354,6195,1159,53,856,250,1038
Newham 004,E02000717,8101,6845,1256,104,902,250,1188
Newham 005,E02000718,6844,5863,981,58,734,189,710
Newham 006,E02000719,8216,6629,1587,64,1220,303,1286
Newham 007,E02000720,7483,6310,1173,57,877,239,921
Newham 008,E02000721,9665,7965,1700,119,1169,412,1202
Newham 009,E02000722,8226,6578,1648,73,1232,343,1480
Newham 010,E02000723,10600,9144,1456,185,804,467,1435
Newham 011,E02000724,9415,8056,1359,133,934,292,1282
Newham 012,E02000725,8876,6902,1974,65,1587,322,1445
Newham 013,E02000726,8892,6597,2295,87,1778,430,1524
Newham 014,E02000727,8305,6932,1373,175,849,349,1154
Newham 015,E02000728,8227,6960,1267,121,814,332,1384
Newham 016,E02000729,7080,5950,1130,45,827,258,885
Newham 017,E02000730,8992,7690,1302,95,857,350,1055
Newham 018,E02000731,10073,8356,1717,200,1117,400,1435
Newham 019,E02000732,7566,6466,1100,50,827,223,877
Newham 020,E02000733,9754,8298,1456,84,1076,296,1159
Newham 021,E02000734,7642,6557,1085,17,848,220,839
Newham 022,E02000735,7582,6394,1188,70,882,236,956
Newham 023,E02000736,8571,7579,992,53,775,164,1068
Newham 024,E02000737,9434,8258,1176,74,891,211,1112
Newham 025,E02000738,8467,7282,1185,86,857,242,1004
Newham 026,E02000739,6894,5789,1105,31,856,218,931
Newham 027,E02000740,6779,5799,980,25,771,184,841
Newham 028,E02000741,8261,7204,1057,45,805,207,1098
Newham 029,E02000742,8005,6894,1111,26,913,172,960
Newham 030,E02000743,7866,6874,992,40,769,183,958
Newham 031,E02000744,8029,6724,1305,87,1002,216,1088
Newham 032,E02000745,8141,7088,1053,55,819,179,1015
Newham 033,E02000746,7382,6004,1378,86,1020,272,889
Newham 034,E02000747,10646,8356,2290,202,1646,442,1465
Newham 035,E02000748,6240,5202,1038,67,765,206,1002
Newham 036,E02000749,8183,7282,901,58,719,124,961
Newham 037,E02000750,10679,8343,2336,210,1794,332,1549
Southwark 001,E02000807,8313,6287,2026,191,1411,424,1371
Southwark 002,E02000808,9102,6548,2554,99,1899,556,1982
Southwark 003,E02000809,11711,8367,3344,327,2224,793,2308
Southwark 004,E02000810,9144,7369,1775,68,1396,311,1234
Southwark 006,E02000812,10290,7796,2494,100,1953,441,1937
Southwark 007,E02000813,8591,6888,1703,61,1331,311,1082
Southwark 008,E02000814,8652,6523,2129,150,1551,428,1542
Southwark 009,E02000815,6497,4347,2150,61,1657,432,1660
Southwark 010,E02000816,9043,7456,1587,50,1284,253,1057
Southwark 011,E02000817,6494,5446,1048,64,804,180,846
Southwark 012,E02000818,7534,6068,1466,52,1196,218,1156
Southwark 013,E02000819,8315,6951,1364,102,1088,174,1132
Southwark 014,E02000820,8503,6580,1923,99,1536,288,1239
Southwark 015,E02000821,8386,7141,1245,77,1028,140,1048
Southwark 016,E02000822,8111,6794,1317,76,1065,176,1225
Southwark 017,E02000823,7733,6335,1398,68,1088,242,1240
Southwark 018,E02000824,9568,8201,1367,94,1096,177,1139
Southwark 019,E02000825,9649,8308,1341,65,1118,158,1090
Southwark 020,E02000826,8888,7465,1423,67,1209,147,1270
Southwark 021,E02000827,10359,8689,1670,70,1351,249,1377
Southwark 022,E02000828,8383,7117,1266,76,1025,165,1137
Southwark 023,E02000829,10389,8531,1858,91,1558,209,1599
Southwark 024,E02000830,8870,7259,1611,53,1338,220,1429
Southwark 025,E02000831,9378,7788,1590,77,1328,185,1365
Southwark 026,E02000832,9960,8500,1460,67,1257,136,1204
Southwark 027,E02000833,7755,6249,1506,65,1205,236,1207
Southwark 028,E02000834,9199,7520,1679,111,1425,143,1505
Southwark 029,E02000835,7236,6133,1103,45,974,84,749
Southwark 030,E02000836,8240,6939,1301,79,1084,138,1208
Southwark 031,E02000837,9085,7819,1266,166,978,122,1104
Southwark 032,E02000838,9180,7689,1491,85,1246,160,1278
Southwark 033,E02000839,8036,6925,1111,61,910,140,954
Southwark 034,E02006802,7689,5593,2096,71,1609,416,1461
Tower Hamlets 001,E02000864,8297,6916,1381,89,1162,130,1105
Tower Hamlets 002,E02000865,7051,5848,1203,36,995,172,939
Tower Hamlets 003,E02000866,9662,7678,1984,98,1649,237,1529
Tower Hamlets 004,E02000867,9761,7279,2482,168,2046,268,1875
Tower Hamlets 005,E02000868,6632,5057,1575,100,1186,289,1157
Tower Hamlets 006,E02000869,5705,4624,1081,38,838,205,813
Tower Hamlets 007,E02000870,6477,5261,1216,53,962,201,958
Tower Hamlets 008,E02000871,8591,6985,1606,170,1246,190,929
Tower Hamlets 009,E02000872,7501,5770,1731,48,1369,314,1320
Tower Hamlets 010,E02000873,8713,5838,2875,91,1912,872,2064
Tower Hamlets 011,E02000874,7129,5842,1287,25,891,371,1103
Tower Hamlets 012,E02000875,9440,7798,1642,67,1344,231,1216
Tower Hamlets 013,E02000876,7037,5546,1491,44,1159,288,1267
Tower Hamlets 014,E02000877,9803,7954,1849,118,1433,298,1420
Tower Hamlets 015,E02000878,10286,7490,2796,137,1889,770,2339
Tower Hamlets 016,E02000879,7634,6181,1453,68,1175,210,1126
Tower Hamlets 017,E02000880,5776,4591,1185,47,946,192,1103
Tower Hamlets 018,E02000881,6909,5944,965,40,831,94,720
Tower Hamlets 019,E02000882,8604,7648,956,50,825,81,918
Tower Hamlets 020,E02000883,7950,6948,1002,65,770,167,1032
Tower Hamlets 021,E02000884,9086,6405,2681,141,2055,485,1970
Tower Hamlets 022,E02000885,6895,5982,913,45,716,152,986
Tower Hamlets 023,E02000886,7326,5875,1451,86,1069,296,1173
Tower Hamlets 024,E02000887,8660,7159,1501,116,1167,218,1145
Tower Hamlets 025,E02000888,8215,6604,1611,94,1172,345,1226
Tower Hamlets 026,E02000889,6616,5266,1350,77,988,285,1186
Tower Hamlets 027,E02000890,5795,4415,1380,123,972,285,962
Tower Hamlets 028,E02000891,12678,9109,3569,302,2482,785,1999
Tower Hamlets 030,E02000893,6783,5538,1245,85,897,263,1010
Tower Hamlets 031,E02000894,10137,7506,2631,248,1751,632,1831
Tower Hamlets 032,E02006853,7064,4948,2116,59,1488,569,849
Tower Hamlets 033,E02006854,5883,3762,2121,139,1384,598,933
Wandsworth 001,E02000923,7474,5789,1685,101,1284,300,1213
Wandsworth 002,E02000924,11131,8829,2302,159,1728,415,1546
Wandsworth 003,E02000925,7848,6671,1177,54,912,211,951
Wandsworth 004,E02000926,8936,6783,2153,137,1637,379,1483
Wandsworth 005,E02000927,6790,5407,1383,40,1199,144,1221
Wandsworth 006,E02000928,8458,6882,1576,182,1145,249,1257
Wandsworth 007,E02000929,7277,6133,1144,57,869,218,918
Wandsworth 008,E02000930,9676,7015,2661,154,2148,359,2112
Wandsworth 009,E02000931,8474,6474,2000,97,1559,344,1658
Wandsworth 010,E02000932,10296,7473,2823,230,2158,435,2147
Wandsworth 011,E02000933,8781,7017,1764,141,1344,279,1485
Wandsworth 012,E02000934,9105,6780,2325,186,1821,318,1805
Wandsworth 013,E02000935,6850,5048,1802,223,1333,246,1281
Wandsworth 014,E02000936,8330,6221,2109,110,1613,386,1539
Wandsworth 015,E02000937,7724,6261,1463,46,1223,194,1364
Wandsworth 016,E02000938,9546,7754,1792,93,1394,305,1202
Wandsworth 017,E02000939,7968,6428,1540,44,1287,209,1293
Wandsworth 018,E02000940,7835,6246,1589,117,1279,193,1228
Wandsworth 019,E02000941,9941,8070,1871,143,1537,191,1986
Wandsworth 020,E02000942,9665,7872,1793,105,1333,355,1485
Wandsworth 021,E02000943,8402,6488,1914,70,1648,196,1687
Wandsworth 022,E02000944,7206,5954,1252,69,944,239,991
Wandsworth 023,E02000945,7620,5688,1932,187,1466,279,1152
Wandsworth 024,E02000946,8795,6589,2206,97,1883,226,1141
Wandsworth 025,E02000947,8675,6907,1768,118,1427,223,1434
Wandsworth 026,E02000948,9877,7329,2548,123,2131,294,2068
Wandsworth 027,E02000949,9805,7740,2065,133,1738,194,1878
Wandsworth 028,E02000950,7578,6035,1543,118,1089,336,1075
Wandsworth 029,E02000951,6650,5116,1534,72,1312,150,1419
Wandsworth 030,E02000952,6257,4892,1365,68,1180,117,1169
Wandsworth 031,E02000953,7084,5163,1921,74,1632,215,1347
Wandsworth 032,E02000954,6429,5256,1173,37,1007,129,1019
Wandsworth 033,E02000955,6714,5544,1170,60,977,133,1123
Wandsworth 034,E02000956,7705,5670,2035,211,1587,237,1372
Wandsworth 035,E02000957,10589,8456,2133,167,1700,266,1645
Wandsworth 036,E02000958,8271,7140,1131,67,905,159,1103
Wandsworth 037,E02000959,7233,6110,1123,127,889,107,990
Westminster 001,E02000960,6620,5233,1387,108,777,502,929
Westminster 002,E02000961,9442,7680,1762,133,1165,464,1337
Westminster 003,E02000962,8624,6741,1883,99,1064,720,1144
Westminster 004,E02000963,10363,9008,1355,139,1016,200,1136
Westminster 005,E02000964,12549,10273,2276,231,1710,335,1674
Westminster 006,E02000965,8627,6570,2057,157,1556,344,1445
Westminster 007,E02000966,9708,7668,2040,178,1308,554,1458
Westminster 008,E02000967,7289,5134,2155,107,1198,850,1233
Westminster 009,E02000968,14358,12489,1869,286,1233,350,1614
Westminster 010,E02000969,9329,7872,1457,120,1129,208,1284
Westminster 011,E02000970,8983,6633,2350,239,1156,955,1407
Westminster 012,E02000971,8408,6043,2365,114,1432,819,1581
Westminster 013,E02000972,8333,5985,2348,116,1599,633,1262
Westminster 014,E02000973,10090,7984,2106,136,1385,585,1582
Westminster 015,E02000974,8794,6520,2274,141,1360,773,1551
Westminster 016,E02000975,8757,6153,2604,148,1454,1002,1605
Westminster 017,E02000976,9946,7027,2919,192,1677,1050,1919
Westminster 018,E02000977,7490,5198,2292,121,1460,711,1544
Westminster 019,E02000978,9270,6371,2899,188,1715,996,2343
Westminster 020,E02000979,8081,6033,2048,73,1384,591,1379
Westminster 021,E02000980,8684,6846,1838,128,1335,375,1130
Westminster 022,E02000981,8991,6741,2250,207,1515,528,1506
Westminster 023,E02000982,8226,6700,1526,95,1111,320,1091
Westminster 024,E02000983,8434,6694,1740,125,1319,296,1111
Barking and Dagenham 001,E02000002,6775,6050,725,38,641,46,537
Barking and Dagenham 002,E02000003,10045,8996,1049,70,878,101,899
Barking and Dagenham 003,E02000004,6182,5599,583,27,520,36,404
Barking and Dagenham 004,E02000005,8562,7695,867,23,746,98,765
Barking and Dagenham 006,E02000007,8791,7583,1208,82,1039,87,804
Barking and Dagenham 007,E02000008,11569,10419,1150,51,990,109,1103
Barking and Dagenham 008,E02000009,8395,7297,1098,64,938,96,869
Barking and Dagenham 009,E02000010,8615,7746,869,52,727,90,781
Barking and Dagenham 010,E02000011,6187,5509,678,34,585,59,636
Barking and Dagenham 011,E02000012,9888,9000,888,48,690,150,851
Barking and Dagenham 012,E02000013,8402,7687,715,29,629,57,746
Barking and Dagenham 013,E02000014,9402,8407,995,72,772,151,889
Barking and Dagenham 014,E02000015,7563,6641,922,72,756,94,820
Barking and Dagenham 015,E02000016,7676,6064,1612,124,1198,290,1212
Barking and Dagenham 016,E02000017,8498,7229,1269,139,865,265,1145
Barking and Dagenham 017,E02000018,8890,7827,1063,87,898,78,966
Barking and Dagenham 018,E02000019,8276,7568,708,36,600,72,786
Barking and Dagenham 019,E02000020,9276,8204,1072,65,846,161,919
Barking and Dagenham 020,E02000021,7904,6792,1112,79,925,108,862
Barking and Dagenham 021,E02000022,8777,7691,1086,70,840,176,884
Barking and Dagenham 022,E02000023,6482,5744,738,57,609,72,705
Barking and Dagenham 023,E02006799,9756,8658,1098,89,840,169,890
Barnet 001,E02000024,10156,8956,1200,150,927,123,865
Barnet 002,E02000025,7956,6998,958,56,828,74,829
Barnet 003,E02000026,6313,5555,758,54,667,37,651
Barnet 004,E02000027,9598,8758,840,59,723,58,839
Barnet 005,E02000028,6166,5388,778,10,684,84,614
Barnet 006,E02000029,8517,7482,1035,80,868,87,869
Barnet 007,E02000030,9130,8260,870,82,675,113,910
Barnet 008,E02000031,7294,6298,996,84,784,128,701
Barnet 009,E02000032,7857,7229,628,27,534,67,644
Barnet 010,E02000033,8537,7688,849,30,737,82,783
Barnet 011,E02000034,8508,7478,1030,44,850,136,916
Barnet 012,E02000035,7965,6694,1271,85,991,195,978
Barnet 013,E02000036,10743,9604,1139,90,923,126,1069
Barnet 014,E02000037,9741,8553,1188,221,826,141,850
Barnet 015,E02000038,10514,9067,1447,113,1168,166,1146
Barnet 016,E02000039,6675,5922,753,77,589,87,724
Barnet 017,E02000040,7197,6181,1016,62,827,127,959
Barnet 018,E02000041,8811,7640,1171,100,884,187,877
Barnet 019,E02000042,10639,8713,1926,143,1456,327,1262
Barnet 020,E02000043,7696,6639,1057,64,732,261,809
Barnet 021,E02000044,8071,7148,923,63,739,121,899
Barnet 022,E02000045,10237,8959,1278,87,1017,174,1070
Barnet 023,E02000046,7063,5663,1400,79,1040,281,1029
Barnet 024,E02000047,11373,9732,1641,180,1199,262,1290
Barnet 025,E02000048,9817,8560,1257,53,991,213,1036
Barnet 026,E02000049,8503,7489,1014,198,710,106,1106
Barnet 027,E02000050,10064,8703,1361,86,1111,164,1217
Barnet 028,E02000051,8647,7174,1473,96,1066,311,1051
Barnet 029,E02000052,9698,7946,1752,135,1428,189,1271
Barnet 030,E02000053,8697,6897,1800,82,1222,496,1065
Barnet 031,E02000054,7206,5973,1233,97,892,244,977
Barnet 032,E02000055,11130,8944,2186,234,1359,593,1494
Barnet 033,E02000056,9212,7901,1311,176,936,199,918
Barnet 034,E02000057,7484,6228,1256,123,846,287,895
Barnet 035,E02000058,10220,8560,1660,167,1174,319,1240
Barnet 036,E02000059,10459,8922,1537,116,1132,289,1310
Barnet 037,E02000060,10920,9124,1796,265,1178,353,1192
Barnet 038,E02000061,8013,6255,1758,137,1278,343,1211
Barnet 039,E02000062,6340,5282,1058,35,855,168,772
Barnet 040,E02000063,6971,5881,1090,65,822,203,896
Barnet 041,E02000064,6248,4989,1259,84,928,247,820
Bexley 001,E02000065,7666,6667,999,73,767,159,869
Bexley 002,E02000066,9641,8374,1267,318,810,139,1050
Bexley 003,E02000067,8750,7710,1040,92,868,80,831
Bexley 004,E02000068,7388,6563,825,49,681,95,722
Bexley 005,E02000069,6194,5649,545,12,481,52,477
Bexley 006,E02000070,7875,7237,638,48,534,56,530
Bexley 007,E02000071,7300,6737,563,31,501,31,571
Bexley 008,E02000072,11734,10581,1153,180,876,97,984
Bexley 009,E02000073,10724,10094,630,39,541,50,562
Bexley 010,E02000074,7655,7005,650,53,569,28,609
Bexley 011,E02000075,7948,7571,377,16,338,23,408
Bexley 013,E02000077,7823,7272,551,31,471,49,447
Bexley 014,E02000078,7665,7228,437,50,369,18,436
Bexley 015,E02000079,7865,7045,820,68,672,80,731
Bexley 016,E02000080,9430,8661,769,45,678,46,622
Bexley 017,E02000081,7513,6969,544,33,490,21,487
Bexley 018,E02000082,8876,8323,553,44,468,41,610
Bexley 019,E02000083,9771,8948,823,92,649,82,689
Bexley 020,E02000084,10641,9931,710,49,619,42,730
Bexley 021,E02000085,7893,7302,591,54,500,37,586
Bexley 022,E02000086,7328,6790,538,42,458,38,489
Bexley 023,E02000087,7579,6933,646,74,534,38,566
Bexley 024,E02000088,7737,7239,498,22,445,31,524
Bexley 025,E02000089,7783,7258,525,37,462,26,529
Bexley 026,E02000090,8726,7580,1146,127,913,106,776
Bexley 027,E02000091,9682,8540,1142,92,946,104,819
Bexley 028,E02000092,6426,5918,508,33,460,15,420
Bexley 029,E02006785,6384,5955,429,32,350,47,440
Brent 001,E02000093,10883,9778,1105,91,819,195,1004
Brent 002,E02000094,8746,7798,948,61,658,229,809
Brent 003,E02000095,9921,8904,1017,107,680,230,974
Brent 004,E02000096,7598,6706,892,60,648,184,865
Brent 005,E02000097,8958,8147,811,61,578,172,915
Brent 006,E02000098,7944,7041,903,46,680,177,1066
Brent 007,E02000099,8707,7439,1268,106,919,243,1031
Brent 008,E02000100,8388,6917,1471,101,987,383,1066
Brent 009,E02000101,9332,8161,1171,69,822,280,1000
Brent 010,E02000102,7787,6872,915,61,712,142,823
Brent 011,E02000103,8723,7630,1093,45,911,137,911
Brent 012,E02000104,6767,5893,874,42,674,158,792
Brent 013,E02000105,9202,7806,1396,147,976,273,1224
Brent 014,E02000106,10217,8858,1359,69,1093,197,1305
Brent 015,E02000107,10692,8508,2184,167,1619,398,1676
Brent 016,E02000108,6584,5679,905,70,659,176,876
Brent 017,E02000109,9864,7993,1871,114,1390,367,927
Brent 018,E02000110,8087,6626,1461,89,1081,291,1182
Brent 019,E02000111,9782,8507,1275,201,777,297,1251
Brent 020,E02000112,9432,8019,1413,147,892,374,1268
Brent 021,E02000113,9655,8712,943,102,733,108,822
Brent 022,E02000114,9010,7164,1846,86,1429,331,1445
Brent 023,E02000115,8340,6457,1883,48,1507,328,1492
Brent 024,E02000116,8153,6627,1526,130,1144,252,1036
Brent 025,E02000117,12013,10352,1661,159,1278,224,1258
Brent 026,E02000118,9425,8402,1023,128,690,205,986
Brent 027,E02000119,7248,6354,894,91,727,76,671
Brent 028,E02000120,9214,7170,2044,143,1597,304,1615
Brent 029,E02000121,8933,7878,1055,111,714,230,1016
Brent 030,E02000122,8079,6893,1186,58,962,166,983
Brent 031,E02000123,14719,12147,2572,348,1830,394,2121
Brent 032,E02000124,10222,8297,1925,112,1545,268,1535
Brent 033,E02000125,10815,9079,1736,143,1356,237,1400
Brent 034,E02000126,7775,6813,962,61,786,115,723
Bromley 001,E02000127,8483,7625,858,93,710,55,710
Bromley 002,E02000128,7294,6575,719,36,636,47,668
Bromley 004,E02000130,7914,6927,987,53,853,81,949
Bromley 005,E02000131,8954,7284,1670,130,1411,129,1380
Bromley 006,E02000132,8567,7086,1481,139,1226,116,1116
Bromley 007,E02000133,9606,8439,1167,142,957,68,980
Bromley 008,E02000134,10773,9063,1710,172,1363,175,1286
Bromley 009,E02000135,9734,8424,1310,125,1042,143,1013
Bromley 010,E02000136,5728,5152,576,11,498,67,446
Bromley 011,E02000137,7826,6797,1029,59,894,76,814
Bromley 012,E02000138,7936,6805,1131,100,906,125,831
Bromley 013,E02000139,7284,6363,921,55,787,79,721
Bromley 014,E02000140,8041,7310,731,62,634,35,620
Bromley 015,E02000141,6940,6165,775,36,686,53,697
Bromley 016,E02000142,8285,7368,917,63,759,95,932
Bromley 018,E02000144,8681,7432,1249,111,1006,132,980
Bromley 019,E02000145,8086,7133,953,104,794,55,678
Bromley 020,E02000146,8324,7283,1041,98,862,81,750
Bromley 021,E02000147,7969,7282,687,35,578,74,583
Bromley 022,E02000148,6585,6099,486,28,425,33,454
Bromley 023,E02000149,7708,7102,606,44,521,41,590
Bromley 024,E02000150,8351,7703,648,57,541,50,628
Bromley 025,E02000151,7574,7032,542,56,429,57,535
Bromley 026,E02000152,6572,5977,595,35,520,40,478
Bromley 027,E02000153,7755,7262,493,16,448,29,477
Bromley 028,E02000154,7959,7124,835,68,699,68,694
Bromley 029,E02000155,6905,6411,494,54,410,30,536
Bromley 030,E02000156,12094,11108,986,155,748,83,849
Bromley 031,E02000157,7964,7430,534,53,445,36,469
Bromley 032,E02000158,7364,6789,575,46,502,27,709
Bromley 033,E02000159,6812,6257,555,56,468,31,566
Bromley 034,E02000160,7856,7224,632,49,538,45,580
Bromley 035,E02000161,8410,7752,658,55,550,53,657
Bromley 036,E02000162,6693,6163,530,48,459,23,448
Bromley 037,E02000163,7650,7018,632,57,540,35,503
Bromley 039,E02000165,7045,6511,534,64,443,27,419
Bromley 040,E02006782,7648,7052,596,53,507,36,654
Bromley 041,E02006787,7594,6945,649,24,579,46,607
Bromley 042,E02006789,6428,5814,614,57,503,54,481
Croydon 001,E02000194,8696,7427,1269,75,1044,150,1080
Croydon 002,E02000195,9152,8198,954,50,799,105,793
Croydon 003,E02000196,7403,6653,750,30,595,125,677
Croydon 004,E02000197,9094,7983,1111,73,884,154,877
Croydon 005,E02000198,8070,7034,1036,72,857,107,845
Croydon 006,E02000199,8430,7576,854,34,754,66,761
Croydon 007,E02000200,8294,7064,1230,99,1000,131,998
Croydon 008,E02000201,8281,7162,1119,68,959,92,818
Croydon 009,E02000202,8548,7649,899,34,700,165,836
Croydon 010,E02000203,7539,6520,1019,52,836,131,778
Croydon 011,E02000204,9407,8199,1208,83,970,155,881
Croydon 013,E02000206,9539,8257,1282,53,1128,101,1234
Croydon 014,E02000207,8999,8160,839,43,744,52,880
Croydon 015,E02000208,9790,8035,1755,104,1489,162,1218
Croydon 016,E02000209,8414,7510,904,72,713,119,937
Croydon 017,E02000210,8310,7460,850,54,721,75,786
Croydon 018,E02000211,8000,7455,545,39,467,39,502
Croydon 019,E02000212,8523,7268,1255,81,998,176,891
Croydon 020,E02000213,9551,7773,1778,138,1405,235,1213
Croydon 021,E02000214,6236,5752,484,12,402,70,527
Croydon 022,E02000215,10518,8406,2112,193,1669,250,1443
Croydon 023,E02000216,6738,5553,1185,174,748,263,747
Croydon 024,E02000217,9688,8018,1670,98,1436,136,1082
Croydon 025,E02000218,6640,6185,455,42,378,35,479
Croydon 026,E02000219,7686,7214,472,31,411,30,584
Croydon 027,E02000220,9881,7615,2266,197,1790,279,1460
Croydon 028,E02000221,9820,8842,978,55,823,100,846
Croydon 029,E02000222,7891,6695,1196,61,1047,88,968
Croydon 030,E02000223,8371,7611,760,80,643,37,666
Croydon 031,E02000224,7684,6676,1008,70,862,76,825
Croydon 032,E02000225,7535,7049,486,62,386,38,439
Croydon 033,E02000226,7539,6938,601,17,506,78,573
Croydon 034,E02000227,11411,10452,959,176,744,39,880
Croydon 035,E02000228,7609,6965,644,33,568,43,578
Croydon 036,E02000229,6374,5799,575,94,449,32,436
Croydon 037,E02000230,10045,8933,1112,67,965,80,892
Croydon 038,E02000231,7685,6905,780,46,662,72,612
Croydon 039,E02000232,6207,5718,489,36,425,28,454
Croydon 040,E02000233,6135,5523,612,30,545,37,495
Croydon 041,E02000234,8023,7304,719,43,620,56,584
Croydon 042,E02000235,6968,6380,588,29,531,28,571
Croydon 043,E02000236,7659,7152,507,51,424,32,499
Croydon 044,E02000237,7475,6974,501,41,425,35,477
Croydon 045,E02006788,7520,6880,640,44,533,63,669
Ealing 001,E02000238,9500,8483,1017,93,776,148,958
Ealing 002,E02000239,9000,8052,948,94,629,225,838
Ealing 003,E02000240,10265,9203,1062,57,865,140,1005
Ealing 004,E02000241,6639,5861,778,54,596,128,691
Ealing 005,E02000242,6763,6029,734,84,521,129,722
Ealing 006,E02000243,8509,7470,1039,79,814,146,954
Ealing 007,E02000244,7172,6294,878,103,611,164,842
Ealing 008,E02000245,8156,7260,896,46,758,92,910
Ealing 009,E02000246,8748,7773,975,76,757,142,815
Ealing 010,E02000247,10308,9042,1266,81,992,193,1090
Ealing 011,E02000248,7334,5988,1346,100,930,316,1031
Ealing 012,E02000249,7721,6745,976,69,740,167,755
Ealing 013,E02000250,6487,5627,860,59,651,150,720
Ealing 014,E02000251,7944,7204,740,60,531,149,672
Ealing 015,E02000252,9706,7554,2152,102,1314,736,1329
Ealing 016,E02000253,9632,8638,994,59,803,132,851
Ealing 017,E02000254,8949,8207,742,79,526,137,863
Ealing 018,E02000255,9465,8139,1326,89,1077,160,1211
Ealing 019,E02000256,8861,7022,1839,89,1393,357,1482
Ealing 020,E02000257,13509,10322,3187,184,2259,744,2069
Ealing 021,E02000258,6730,5501,1229,50,830,349,877
Ealing 022,E02000259,6276,5489,787,45,642,100,749
Ealing 023,E02000260,8710,7767,943,66,674,203,938
Ealing 024,E02000261,10766,8650,2116,119,1414,583,1306
Ealing 025,E02000262,8925,7184,1741,100,1319,322,1379
Ealing 026,E02000263,11637,10396,1241,288,645,308,1253
Ealing 027,E02000264,8103,6444,1659,79,1254,326,1254
Ealing 028,E02000265,11119,9175,1944,136,1505,303,1624
Ealing 029,E02000266,12331,10910,1421,134,1099,188,1288
Ealing 030,E02000267,6926,5980,946,62,763,121,780
Ealing 031,E02000268,9358,7843,1515,86,1164,265,1327
Ealing 032,E02000269,8078,6621,1457,82,1187,188,1172
Ealing 033,E02000270,8043,6751,1292,83,1034,175,1098
Ealing 034,E02000271,6763,5556,1207,74,905,228,1047
Ealing 035,E02000272,6748,5919,829,60,643,126,740
Ealing 037,E02000274,12733,11111,1622,344,862,416,1419
Ealing 038,E02000275,7102,6264,838,52,622,164,756
Ealing 039,E02000276,6722,5389,1333,81,939,313,1119
Ealing 040,E02006791,6711,5302,1409,88,1137,184,1200
Enfield 001,E02000277,7081,6392,689,19,630,40,676
Enfield 002,E02000278,8837,7917,920,69,781,70,849
Enfield 003,E02000279,11292,9708,1584,154,1347,83,1079
Enfield 004,E02000280,8515,7764,751,83,635,33,670
Enfield 005,E02000281,8835,7871,964,45,863,56,732
Enfield 006,E02000282,9115,7961,1154,101,975,78,891
Enfield 007,E02000283,8424,7675,749,60,640,49,713
Enfield 008,E02000284,8200,7271,929,76,802,51,799
Enfield 009,E02000285,6597,6168,429,22,366,41,481
Enfield 010,E02000286,8158,7055,1103,93,939,71,958
Enfield 011,E02000287,6823,5933,890,46,713,131,736
Enfield 012,E02000288,10490,8893,1597,104,1395,98,1053
Enfield 013,E02000289,6569,6166,403,2,356,45,445
Enfield 014,E02000290,7242,6381,861,61,729,71,748
Enfield 015,E02000291,8924,7666,1258,81,1096,81,1114
Enfield 016,E02000292,9518,8609,909,47,789,73,853
Enfield 017,E02000293,6307,5766,541,31,466,44,506
Enfield 018,E02000294,8879,7903,976,47,825,104,905
Enfield 019,E02000295,8374,7369,1005,74,826,105,803
Enfield 020,E02000296,9535,7985,1550,111,1255,184,1125
Enfield 021,E02000297,9298,8529,769,61,654,54,728
Enfield 022,E02000298,7976,7152,824,70,694,60,798
Enfield 023,E02000299,9312,8045,1267,63,1078,126,1210
Enfield 024,E02000300,8157,6984,1173,59,986,128,1066
Enfield 025,E02000301,10070,8773,1297,71,1122,104,1194
Enfield 026,E02000302,8326,7507,819,52,666,101,730
Enfield 027,E02000303,8390,7234,1156,63,994,99,1080
Enfield 028,E02000304,8089,7239,850,45,724,81,692
Enfield 029,E02000305,8633,7309,1324,97,1090,137,1008
Enfield 030,E02000306,9149,8195,954,53,832,69,869
Enfield 031,E02000307,9873,8846,1027,28,895,104,956
Enfield 032,E02000308,7736,6617,1119,66,885,168,1098
Enfield 033,E02000309,10489,9220,1269,114,1019,136,1238
Enfield 035,E02000311,9872,8597,1275,61,1047,167,1146
Enfield 036,E02000312,10473,8524,1949,88,1615,246,1574
Enfield 037,E02006793,8908,7760,1148,93,946,109,937
Greenwich 001,E02000313,6566,5708,858,59,696,103,626
Greenwich 002,E02000314,13164,11147,2017,228,1535,254,1609
Greenwich 003,E02000315,9080,8017,1063,84,863,116,872
Greenwich 004,E02000316,10750,8103,2647,196,2079,372,1573
Greenwich 005,E02000317,8370,7356,1014,64,826,124,947
Greenwich 006,E02000318,9842,8298,1544,229,970,345,1257
Greenwich 007,E02000319,10971,9022,1949,198,1422,329,1324
Greenwich 008,E02000320,6624,5918,706,60,561,85,654
Greenwich 009,E02000321,7200,6113,1087,48,860,179,871
Greenwich 011,E02000323,10674,9064,1610,159,1220,231,1503
Greenwich 012,E02000324,7315,6373,942,69,748,125,757
Greenwich 014,E02000326,7070,6039,1031,53,846,132,931
Greenwich 015,E02000327,6825,5180,1645,45,1030,570,940
Greenwich 016,E02000328,6606,5555,1051,49,883,119,752
Greenwich 017,E02000329,6180,5673,507,13,443,51,511
Greenwich 019,E02000331,7831,6709,1122,41,968,113,887
Greenwich 020,E02000332,7253,6487,766,60,622,84,697
Greenwich 021,E02000333,6269,5171,1098,60,897,141,997
Greenwich 022,E02000334,6469,5829,640,12,560,68,579
Greenwich 023,E02000335,6549,6071,478,47,407,24,451
Greenwich 025,E02000337,7906,7191,715,77,580,58,666
Greenwich 027,E02000339,5970,5492,478,38,396,44,432
Greenwich 028,E02000340,6088,5404,684,32,567,85,588
Greenwich 029,E02000341,7683,7041,642,29,549,64,663
Greenwich 030,E02000342,6453,4930,1523,96,1185,242,882
Greenwich 031,E02000343,6675,6086,589,18,524,47,525
Greenwich 032,E02000344,6387,5833,554,21,469,64,475
Greenwich 033,E02006786,6894,6185,709,29,595,85,756
Greenwich 034,E02006927,8315,7213,1102,320,657,125,1471
Greenwich 035,E02006928,7341,5060,2281,115,1685,481,1390
Greenwich 036,E02006929,7490,5648,1842,98,1480,264,1124
Greenwich 037,E02006930,6561,5163,1398,120,1041,237,1184
Greenwich 038,E02006931,9186,7330,1856,106,1406,344,1451
Harrow 001,E02000433,7686,6857,829,69,639,121,780
Harrow 002,E02000434,8588,7437,1151,56,982,113,739
Harrow 003,E02000435,7426,6570,856,32,703,121,660
Harrow 004,E02000436,5782,5325,457,10,405,42,509
Harrow 005,E02000437,8377,7517,860,46,710,104,756
Harrow 006,E02000438,7910,7039,871,41,731,99,677
Harrow 007,E02000439,8206,7172,1034,96,759,179,907
Harrow 008,E02000440,9569,8737,832,28,686,118,838
Harrow 009,E02000441,6714,6035,679,13,587,79,664
Harrow 010,E02000442,8706,7690,1016,92,726,198,942
Harrow 011,E02000443,9470,8274,1196,96,905,195,964
Harrow 012,E02000444,8499,7735,764,67,557,140,803
Harrow 013,E02000445,10250,8723,1527,162,1122,243,1199
Harrow 015,E02000447,7058,6510,548,36,431,81,615
Harrow 016,E02000448,6641,5952,689,51,549,89,659
Harrow 017,E02000449,8137,7350,787,69,557,161,791
Harrow 019,E02000451,6550,5939,611,49,467,95,536
Harrow 020,E02000452,8218,6708,1510,147,1108,255,1359
Harrow 021,E02000453,7620,6609,1011,70,751,190,817
Harrow 022,E02000454,7082,6521,561,30,448,83,570
Harrow 023,E02000455,8135,6470,1665,133,1093,439,1225
Harrow 024,E02000456,7059,6140,919,39,725,155,909
Harrow 025,E02000457,6314,5728,586,70,416,100,538
Harrow 027,E02000459,8235,6984,1251,63,1011,177,954
Harrow 028,E02000460,6518,5884,634,43,484,107,760
Harrow 029,E02000461,6947,5618,1329,96,997,236,810
Harrow 030,E02000462,6632,5827,805,112,539,154,799
Harrow 031,E02000463,8429,7666,763,60,574,129,749
Harrow 032,E02006795,8124,7322,802,47,587,168,754
Harrow 033,E02006882,14174,12851,1323,119,982,222,1390
Havering 001,E02000464,6451,6005,446,40,390,16,422
Havering 002,E02000465,7930,7286,644,68,546,30,543
Havering 003,E02000466,8287,7655,632,61,527,44,553
Havering 004,E02000467,9643,8820,823,90,693,40,770
Havering 005,E02000468,7782,7300,482,27,423,32,492
Havering 006,E02000469,6443,5837,606,45,523,38,423
Havering 007,E02000470,7887,7228,659,74,563,22,585
Havering 008,E02000471,7457,7015,442,21,403,18,460
Havering 009,E02000472,8989,8379,610,55,514,41,536
Havering 010,E02000473,9588,8832,756,46,685,25,681
Havering 011,E02000474,8343,7593,750,55,650,45,671
Havering 012,E02000475,9196,8221,975,62,851,62,772
Havering 013,E02000476,8414,7111,1303,93,1079,131,1038
Havering 014,E02000477,9360,8681,679,46,607,26,666
Havering 015,E02000478,5885,5427,458,65,370,23,402
Havering 016,E02000479,8134,7118,1016,65,884,67,790
Havering 017,E02000480,9795,8653,1142,99,914,129,839
Havering 018,E02000481,7793,7236,557,85,445,27,415
Havering 019,E02000482,6396,5960,436,41,361,34,405
Havering 020,E02000483,7614,6923,691,41,609,41,637
Havering 021,E02000484,8199,7666,533,44,454,35,525
Havering 022,E02000485,7986,7354,632,37,549,46,544
Havering 023,E02000486,7366,6835,531,49,454,28,480
Havering 024,E02000487,7843,7358,485,47,400,38,497
Havering 025,E02000488,7431,6999,432,25,395,12,442
Havering 026,E02000489,7884,7344,540,61,429,50,549
Havering 027,E02000490,7828,7325,503,32,457,14,519
Havering 028,E02000491,8826,8014,812,181,594,37,570
Havering 029,E02000492,6272,5959,313,30,264,19,303
Havering 030,E02000493,6210,5690,520,93,386,41,451
Hillingdon 001,E02000494,7479,6617,862,63,652,147,671
Hillingdon 002,E02000495,9473,8295,1178,138,887,153,873
Hillingdon 003,E02000496,7399,6635,764,144,547,73,597
Hillingdon 004,E02000497,8529,7516,1013,63,888,62,635
Hillingdon 005,E02000498,6020,5506,514,72,401,41,525
Hillingdon 006,E02000499,7765,7201,564,50,454,60,567
Hillingdon 007,E02000500,7714,6843,871,62,704,105,694
Hillingdon 008,E02000501,8247,7593,654,35,565,54,596
Hillingdon 009,E02000502,7613,6686,927,74,791,62,849
Hillingdon 010,E02000503,8986,8160,826,63,705,58,707
Hillingdon 011,E02000504,7382,6788,594,64,490,40,590
Hillingdon 013,E02000506,7541,6891,650,49,513,88,603
Hillingdon 014,E02000507,7943,7294,649,51,537,61,622
Hillingdon 015,E02000508,9184,5804,3380,202,2568,610,2441
Hillingdon 016,E02000509,9823,6390,3433,316,2477,640,1451
Hillingdon 017,E02000510,8634,7413,1221,84,995,142,857
Hillingdon 018,E02000511,9426,8557,869,47,674,148,809
Hillingdon 019,E02000512,8001,7013,988,37,826,125,889
Hillingdon 020,E02000513,8980,8059,921,55,741,125,934
Hillingdon 021,E02000514,9820,8711,1109,96,838,175,982
Hillingdon 022,E02000515,10439,8680,1759,135,1384,240,1333
Hillingdon 023,E02000516,8269,7413,856,67,645,144,847
Hillingdon 024,E02000517,8626,7581,1045,81,854,110,882
Hillingdon 025,E02000518,8606,7646,960,52,781,127,809
Hillingdon 026,E02000519,8658,7817,841,32,679,130,758
Hillingdon 027,E02000520,11251,9770,1481,144,1139,198,1247
Hillingdon 028,E02000521,9912,8560,1352,80,1082,190,912
Hillingdon 029,E02000522,8653,7571,1082,106,796,180,843
Hillingdon 030,E02000523,9636,8355,1281,114,956,211,1059
Hillingdon 031,E02000524,6663,5363,1300,84,1055,161,1021
Hillingdon 032,E02000525,8826,7444,1382,212,934,236,1076
Hillingdon 033,E02006796,8438,7610,828,74,680,74,902
Hounslow 001,E02000526,8378,6833,1545,138,1142,265,1335
Hounslow 003,E02000528,10614,8832,1782,220,1362,200,992
Hounslow 004,E02000529,8448,7470,978,120,711,147,817
Hounslow 005,E02000530,6837,6097,740,50,560,130,739
Hounslow 006,E02000531,10337,8275,2062,97,1638,327,1411
Hounslow 007,E02000532,9160,7758,1402,105,1042,255,1188
Hounslow 008,E02000533,8406,6938,1468,146,1121,201,1139
Hounslow 009,E02000534,8044,6845,1199,92,905,202,881
Hounslow 010,E02000535,9291,8289,1002,83,706,213,1046
Hounslow 011,E02000536,9269,8168,1101,49,791,261,1001
Hounslow 012,E02000537,8620,7257,1363,134,853,376,1276
Hounslow 013,E02000538,8680,7447,1233,143,837,253,1119
Hounslow 014,E02000539,10752,8866,1886,140,1546,200,1189
Hounslow 015,E02000540,9246,7727,1519,127,1065,327,1130
Hounslow 016,E02000541,8875,7593,1282,187,753,342,1140
Hounslow 017,E02000542,9396,7726,1670,181,1111,378,1325
Hounslow 018,E02000543,11713,9244,2469,302,1501,666,1801
Hounslow 019,E02000544,8199,7339,860,48,685,127,768
Hounslow 020,E02000545,8181,7103,1078,95,867,116,937
Hounslow 021,E02000546,9750,8348,1402,111,893,398,1129
Hounslow 022,E02000547,9360,8218,1142,101,885,156,1015
Hounslow 023,E02000548,9103,7864,1239,99,1043,97,846
Hounslow 024,E02000549,11017,9617,1400,118,1110,172,1132
Hounslow 025,E02000550,10403,9029,1374,138,978,258,1088
Hounslow 026,E02000551,8614,7690,924,80,760,84,846
Hounslow 027,E02000552,8266,7010,1256,109,1039,108,915
Hounslow 028,E02000553,6605,5973,632,51,543,38,539
Hounslow 029,E02006792,8393,6394,1999,133,1446,420,1376
Kingston upon Thames 001,E02000598,7837,7057,780,77,600,103,662
Kingston upon Thames 002,E02000599,7270,5881,1389,97,987,305,965
Kingston upon Thames 003,E02000600,8225,6437,1788,117,1387,284,1164
Kingston upon Thames 004,E02000601,10409,8296,2113,249,1578,286,1336
Kingston upon Thames 005,E02000602,9390,7335,2055,201,1656,198,1433
Kingston upon Thames 006,E02000603,7860,6789,1071,67,856,148,906
Kingston upon Thames 007,E02000604,8586,7368,1218,129,911,178,996
Kingston upon Thames 008,E02000605,7863,6848,1015,74,816,125,848
Kingston upon Thames 009,E02000606,10107,7130,2977,277,2253,447,2018
Kingston upon Thames 010,E02000607,6829,5116,1713,108,1356,249,1310
Kingston upon Thames 011,E02000608,6993,4593,2400,166,1933,301,1546
Kingston upon Thames 012,E02000609,7437,6775,662,42,504,116,650
Kingston upon Thames 013,E02000610,7629,5876,1753,88,1504,161,1441
Kingston upon Thames 014,E02000611,7313,6734,579,47,463,69,627
Kingston upon Thames 015,E02000612,8028,7284,744,43,602,99,745
Kingston upon Thames 016,E02000613,7841,6705,1136,59,996,81,888
Kingston upon Thames 017,E02000614,8404,7374,1030,148,728,154,839
Kingston upon Thames 018,E02000615,7471,6770,701,61,580,60,613
Kingston upon Thames 019,E02000616,6031,5547,484,64,367,53,493
Kingston upon Thames 020,E02000617,8537,7697,840,97,689,54,576
Merton 001,E02000689,8258,6836,1422,87,1102,233,1144
Merton 002,E02000690,5656,4870,786,67,542,177,656
Merton 003,E02000691,7334,5794,1540,75,1187,278,1180
Merton 004,E02000692,7662,6002,1660,146,1162,352,1199
Merton 005,E02000693,9173,7208,1965,126,1507,332,1497
Merton 006,E02000694,8730,7056,1674,103,1348,223,1378
Merton 007,E02000695,8287,7229,1058,95,799,164,1075
Merton 008,E02000696,8072,6722,1350,63,1035,252,1080
Merton 009,E02000697,8217,6314,1903,120,1458,325,1380
Merton 010,E02000698,7816,6736,1080,102,786,192,859
Merton 011,E02000699,7689,6351,1338,80,1085,173,994
Merton 012,E02000700,8290,7200,1090,48,895,147,1044
Merton 013,E02000701,8416,7533,883,77,649,157,940
Merton 014,E02000702,7638,6911,727,28,587,112,737
Merton 015,E02000703,7825,6822,1003,97,757,149,873
Merton 016,E02000704,7742,6485,1257,68,1040,149,971
Merton 017,E02000705,8124,7336,788,40,613,135,768
Merton 018,E02000706,8605,7602,1003,102,770,131,862
Merton 019,E02000707,7486,6800,686,42,575,69,617
Merton 020,E02000708,8286,7352,934,80,706,148,806
Merton 021,E02000709,7701,7080,621,24,486,111,607
Merton 022,E02000710,8329,7367,962,81,766,115,870
Merton 023,E02000711,8158,7136,1022,98,751,173,865
Merton 024,E02000712,8709,7806,903,74,715,114,839
Merton 025,E02000713,7490,7000,490,42,382,66,490
Redbridge 001,E02000751,10422,9389,1033,109,818,106,830
Redbridge 002,E02000752,6815,6261,554,22,490,42,426
Redbridge 003,E02000753,6138,5684,454,26,382,46,435
Redbridge 004,E02000754,6440,5853,587,44,496,47,557
Redbridge 005,E02000755,5218,4714,504,17,450,37,443
Redbridge 006,E02000756,12630,11248,1382,120,1125,137,1076
Redbridge 007,E02000757,11516,9873,1643,206,1292,145,1293
Redbridge 008,E02000758,5953,5440,513,14,450,49,512
Redbridge 009,E02000759,12044,10784,1260,106,1022,132,1109
Redbridge 010,E02000760,6957,6282,675,49,543,83,553
Redbridge 012,E02000762,6290,5778,512,10,433,69,564
Redbridge 013,E02000763,6928,6284,644,30,534,80,631
Redbridge 014,E02000764,11865,10166,1699,222,1321,156,1311
Redbridge 015,E02000765,6319,5547,772,38,612,122,666
Redbridge 017,E02000767,7616,6781,835,75,597,163,701
Redbridge 018,E02000768,5660,5075,585,38,468,79,555
Redbridge 019,E02000769,14257,12620,1637,140,1345,152,1283
Redbridge 020,E02000770,7562,6724,838,50,601,187,665
Redbridge 022,E02000772,7946,6825,1121,82,840,199,956
Redbridge 023,E02000773,9198,8112,1086,73,849,164,860
Redbridge 024,E02000774,7218,6272,946,55,698,193,693
Redbridge 026,E02000776,6372,5421,951,61,733,157,677
Redbridge 027,E02000777,5883,5351,532,36,445,51,500
Redbridge 029,E02000779,7751,6269,1482,85,1072,325,1277
Redbridge 030,E02000780,14666,12295,2371,223,1522,626,1530
Redbridge 031,E02000781,13672,12381,1291,80,994,217,1159
Redbridge 032,E02000782,9289,7807,1482,93,1023,366,1074
Redbridge 033,E02000783,7255,6321,934,62,738,134,748
Redbridge 034,E02006800,13069,11405,1664,146,1199,319,1488
Redbridge 035,E02006924,12780,11457,1323,111,963,249,1082
Redbridge 036,E02006925,13241,12162,1079,79,858,142,976
Richmond upon Thames 001,E02000784,10299,8677,1622,292,1000,330,1108
Richmond upon Thames 002,E02000785,9695,8046,1649,224,1106,319,1177
Richmond upon Thames 003,E02000786,10919,9112,1807,241,1309,257,1498
Richmond upon Thames 004,E02000787,10768,8987,1781,121,1288,372,1280
Richmond upon Thames 005,E02000788,8692,7241,1451,207,1073,171,1000
Richmond upon Thames 006,E02000789,6196,5078,1118,86,779,253,921
Richmond upon Thames 007,E02000790,6193,5126,1067,119,778,170,774
Richmond upon Thames 008,E02000791,6137,4601,1536,128,977,431,1005
Richmond upon Thames 009,E02000792,6989,5648,1341,144,880,317,971
Richmond upon Thames 010,E02000793,8122,7162,960,66,795,99,731
Richmond upon Thames 011,E02000794,6609,5656,953,54,787,112,818
Richmond upon Thames 012,E02000795,6898,5954,944,58,738,148,754
Richmond upon Thames 013,E02000796,10313,9259,1054,109,841,104,872
Richmond upon Thames 014,E02000797,6979,5510,1469,187,1106,176,1072
Richmond upon Thames 015,E02000798,10528,9253,1275,141,1063,71,1101
Richmond upon Thames 016,E02000799,6415,5025,1390,72,1182,136,1019
Richmond upon Thames 017,E02000800,5184,4568,616,84,456,76,435
Richmond upon Thames 018,E02000801,6608,5610,998,58,869,71,836
Richmond upon Thames 019,E02000802,6747,5916,831,59,718,54,714
Richmond upon Thames 020,E02000803,9387,8385,1002,97,834,71,811
Richmond upon Thames 021,E02000804,7106,5910,1196,91,979,126,841
Richmond upon Thames 022,E02000805,10221,8534,1687,188,1282,217,1308
Richmond upon Thames 023,E02000806,9985,8865,1120,141,898,81,890
Sutton 001,E02000840,8171,7518,653,38,573,42,541
Sutton 002,E02000841,8721,7947,774,77,646,51,736
Sutton 003,E02000842,7666,7155,511,17,446,48,529
Sutton 004,E02000843,7495,6741,754,64,640,50,767
Sutton 005,E02000844,7779,7083,696,40,623,33,621
Sutton 006,E02000845,8867,7941,926,105,707,114,829
Sutton 007,E02000846,7053,6384,669,44,533,92,595
Sutton 008,E02000847,8798,8057,741,42,638,61,598
Sutton 009,E02000848,7889,7330,559,44,468,47,506
Sutton 010,E02000849,7485,6794,691,47,596,48,647
Sutton 011,E02000850,10309,9565,744,57,637,50,788
Sutton 012,E02000851,8330,7130,1200,105,979,116,992
Sutton 013,E02000852,7434,6695,739,42,645,52,683
Sutton 014,E02000853,7592,6856,736,37,651,48,643
Sutton 015,E02000854,7101,6418,683,38,605,40,708
Sutton 016,E02000855,7787,7105,682,61,565,56,652
Sutton 017,E02000856,8176,7319,857,77,723,57,764
Sutton 018,E02000857,7905,6577,1328,106,1071,151,1067
Sutton 019,E02000858,7691,7050,641,91,513,37,553
Sutton 020,E02000859,8165,7356,809,68,673,68,693
Sutton 021,E02000860,7598,6284,1314,108,1085,121,1003
Sutton 022,E02000861,7497,6950,547,49,450,48,632
Sutton 024,E02000863,6367,5930,437,18,379,40,479
Sutton 025,E02006836,8270,7421,849,68,706,75,779
Waltham Forest 001,E02000895,7979,7462,517,34,453,30,457
Waltham Forest 002,E02000896,8814,7928,886,98,721,67,1042
Waltham Forest 003,E02000897,8077,7495,582,21,536,25,527
Waltham Forest 004,E02000898,7750,7144,606,23,558,25,541
Waltham Forest 005,E02000899,7920,7304,616,31,529,56,642
Waltham Forest 006,E02000900,8088,7391,697,30,601,66,704
Waltham Forest 007,E02000901,9371,8595,776,74,644,58,675
Waltham Forest 008,E02000902,8231,7424,807,26,703,78,753
Waltham Forest 009,E02000903,9043,8100,943,26,799,118,886
Waltham Forest 010,E02000904,8228,7316,912,28,725,159,989
Waltham Forest 011,E02000905,9589,8158,1431,63,1229,139,1115
Waltham Forest 012,E02000906,9248,7986,1262,86,995,181,1107
Waltham Forest 013,E02000907,9998,8731,1267,59,1082,126,1139
Waltham Forest 014,E02000908,10516,8583,1933,93,1621,219,1254
Waltham Forest 015,E02000909,8640,7447,1193,68,1009,116,1048
Waltham Forest 016,E02000910,10698,8905,1793,117,1363,313,1629
Waltham Forest 017,E02000911,10872,9250,1622,117,1257,248,1527
Waltham Forest 018,E02000912,9238,8011,1227,61,875,291,1161
Waltham Forest 019,E02000913,8706,7596,1110,56,883,171,1221
Waltham Forest 020,E02000914,10594,9176,1418,98,1117,203,1295
Waltham Forest 021,E02000915,8643,7075,1568,84,1277,207,1196
Waltham Forest 022,E02000916,9485,8121,1364,76,1091,197,1188
Waltham Forest 023,E02000917,9171,7616,1555,120,1220,215,1330
Waltham Forest 024,E02000918,9126,7642,1484,78,1116,290,1401
Waltham Forest 025,E02000919,9221,7483,1738,74,1294,370,1365
Waltham Forest 026,E02000920,9479,7888,1591,95,1235,261,1402
Waltham Forest 027,E02000921,11001,9408,1593,138,1157,298,1482
Waltham Forest 028,E02000922,10523,8471,2052,119,1650,283,1530
Bracknell Forest 001,E02003352,5816,5332,484,34,410,40,481
Bracknell Forest 002,E02003353,8689,7563,1126,114,876,136,755
Bracknell Forest 003,E02003354,9867,8872,995,108,809,78,884
Bracknell Forest 004,E02003355,6369,5697,672,65,546,61,537
Bracknell Forest 005,E02003356,7022,6091,931,63,717,151,669
Bracknell Forest 006,E02003357,8924,7827,1097,131,850,116,981
Bracknell Forest 007,E02003358,9082,7751,1331,126,1100,105,858
Bracknell Forest 008,E02003359,6409,5613,796,65,684,47,722
Bracknell Forest 009,E02003360,9493,8404,1089,76,944,69,797
Bracknell Forest 010,E02003361,7410,6656,754,61,647,46,678
Bracknell Forest 011,E02003362,6581,5912,669,44,575,50,603
Bracknell Forest 012,E02003363,6692,5701,991,109,782,100,598
Bracknell Forest 013,E02003364,6653,6040,613,62,512,39,626
Bracknell Forest 014,E02003365,6670,6002,668,79,558,31,585
Bracknell Forest 015,E02003366,7528,6153,1375,80,1150,145,1044
Brighton and Hove 001,E02003491,7726,7070,656,52,583,21,574
Brighton and Hove 002,E02003492,9491,5054,4437,289,3297,851,3781
Brighton and Hove 003,E02003493,7824,7042,782,50,669,63,721
Brighton and Hove 004,E02003494,6514,5848,666,21,580,65,620
Brighton and Hove 005,E02003495,7200,6684,516,46,453,17,525
Brighton and Hove 006,E02003496,7430,6852,578,55,480,43,536
Brighton and Hove 007,E02003497,7291,6628,663,61,543,59,666
Brighton and Hove 008,E02003498,8382,6493,1889,157,1608,124,1355
Brighton and Hove 009,E02003499,8022,6447,1575,89,1400,86,1241
Brighton and Hove 010,E02003500,8360,6878,1482,95,1288,99,1120
Brighton and Hove 011,E02003501,8322,6989,1333,97,1105,131,1085
Brighton and Hove 012,E02003502,7574,6935,639,52,551,36,641
Brighton and Hove 013,E02003503,8974,8075,899,74,765,60,764
Brighton and Hove 014,E02003504,8390,6650,1740,112,1479,149,1510
Brighton and Hove 015,E02003505,8984,5713,3271,307,2727,237,2274
Brighton and Hove 016,E02003506,6760,5870,890,46,777,67,833
Brighton and Hove 017,E02003507,9793,9118,675,76,557,42,662
Brighton and Hove 018,E02003508,8741,6049,2692,172,2352,168,1932
Brighton and Hove 019,E02003509,8704,6746,1958,123,1641,194,1609
Brighton and Hove 020,E02003510,8509,6816,1693,102,1392,199,1445
Brighton and Hove 021,E02003511,7986,7069,917,92,759,66,850
Brighton and Hove 022,E02003512,9079,6094,2985,265,2516,204,2188
Brighton and Hove 023,E02003513,6619,5643,976,60,827,89,757
Brighton and Hove 024,E02003514,8437,6128,2309,186,1911,212,1791
Brighton and Hove 025,E02003515,9086,8165,921,132,747,42,764
Brighton and Hove 026,E02003516,8366,5977,2389,186,1969,234,1811
Brighton and Hove 027,E02003517,10818,6990,3828,330,3007,491,2849
Brighton and Hove 028,E02003518,7572,5968,1604,81,1361,162,1299
Brighton and Hove 029,E02003519,8669,5954,2715,200,2222,293,2009
Brighton and Hove 030,E02003520,8645,6266,2379,171,1992,216,1679
Brighton and Hove 031,E02003521,8083,6083,2000,139,1640,221,1468
Brighton and Hove 032,E02003522,7047,5373,1674,121,1295,258,1240
Brighton and Hove 033,E02003523,9971,8818,1153,163,852,138,791
Isle of Wight 001,E02003581,7830,6541,1289,298,902,89,820
Isle of Wight 002,E02003582,8210,7472,738,183,522,33,498
Isle of Wight 003,E02003583,6459,5751,708,144,543,21,432
Isle of Wight 004,E02003584,6233,5116,1117,230,829,58,657
Isle of Wight 005,E02003585,6662,6020,642,104,507,31,529
Isle of Wight 006,E02003586,7664,6860,804,128,652,24,580
Isle of Wight 007,E02003587,8408,7266,1142,202,904,36,688
Isle of Wight 008,E02003588,7463,6666,797,67,715,15,682
Isle of Wight 009,E02003589,8494,7010,1484,240,1200,44,864
Isle of Wight 010,E02003590,7450,6629,821,206,556,59,505
Isle of Wight 011,E02003591,9226,8379,847,158,650,39,647
Isle of Wight 012,E02003592,9482,8523,959,340,567,52,456
Isle of Wight 013,E02003593,5308,4872,436,34,367,35,421
Isle of Wight 014,E02003594,9219,8114,1105,311,746,48,854
Isle of Wight 015,E02003595,8085,7477,608,90,500,18,572
Isle of Wight 016,E02003596,8726,7530,1196,301,848,47,685
Isle of Wight 017,E02003597,5617,5161,456,82,358,16,367
Isle of Wight 018,E02003598,7729,6937,792,255,504,33,466
Medway 001,E02003314,6310,5756,554,122,420,12,414
Medway 002,E02003315,5556,5091,465,85,367,13,398
Medway 003,E02003316,9692,8790,902,170,712,20,665
Medway 004,E02003317,5903,5363,540,52,463,25,338
Medway 005,E02003318,5998,5560,438,20,407,11,360
Medway 006,E02003319,7768,6861,907,139,731,37,675
Medway 007,E02003320,8258,6133,2125,140,1780,205,1283
Medway 008,E02003321,6087,5529,558,67,474,17,485
Medway 009,E02003322,6975,5134,1841,182,1497,162,930
Medway 010,E02003323,7265,6439,826,77,722,27,638
Medway 011,E02003324,8989,8098,891,93,774,24,715
Medway 012,E02003325,7000,5677,1323,174,967,182,1041
Medway 013,E02003326,7787,7003,784,88,656,40,763
Medway 014,E02003327,7314,5933,1381,143,1130,108,921
Medway 015,E02003328,8279,6195,2084,195,1625,264,1490
Medway 016,E02003329,6656,5563,1093,106,877,110,872
Medway 017,E02003330,6755,5971,784,75,664,45,700
Medway 018,E02003331,8789,8138,651,134,499,18,661
Medway 019,E02003332,6002,5460,542,37,476,29,522
Medway 020,E02003333,6704,5575,1129,135,881,113,992
Medway 021,E02003334,5961,5139,822,77,660,85,600
Medway 022,E02003335,7135,6118,1017,119,825,73,738
Medway 023,E02003336,5856,5447,409,25,353,31,350
Medway 024,E02003337,7061,6199,862,51,775,36,641
Medway 025,E02003338,7030,6365,665,84,551,30,554
Medway 026,E02003339,6277,5754,523,42,454,27,432
Medway 027,E02003340,7792,7060,732,71,644,17,597
Medway 028,E02003341,5448,5037,411,64,322,25,321
Medway 029,E02003342,6270,5798,472,36,418,18,470
Medway 030,E02003343,5954,5591,363,15,324,24,384
Medway 031,E02003344,7022,6489,533,21,499,13,518
Medway 032,E02003345,5903,5488,415,27,374,14,414
Medway 033,E02003346,6228,5768,460,35,404,21,424
Medway 034,E02003347,6228,5676,552,79,459,14,548
Medway 035,E02003348,8003,7422,581,77,483,21,452
Medway 036,E02003349,7478,6959,519,77,419,23,478
Medway 037,E02003350,6291,5852,439,35,390,14,458
Medway 038,E02003351,7901,7312,589,118,458,13,558
Milton Keynes 001,E02003459,8735,7829,906,293,555,58,564
Milton Keynes 002,E02003460,9234,8081,1153,125,953,75,662
Milton Keynes 003,E02003461,7392,6679,713,126,559,28,534
Milton Keynes 004,E02003462,7726,6936,790,171,583,36,668
Milton Keynes 005,E02003463,6755,6109,646,46,544,56,609
Milton Keynes 006,E02003464,6744,6090,654,53,556,45,585
Milton Keynes 007,E02003465,6215,5528,687,53,588,46,563
Milton Keynes 008,E02003466,7258,6149,1109,146,876,87,658
Milton Keynes 009,E02003467,6371,5590,781,59,613,109,639
Milton Keynes 010,E02003468,7382,6421,961,109,775,77,613
Milton Keynes 011,E02003469,5801,5295,506,19,425,62,532
Milton Keynes 012,E02003470,5620,5038,582,73,477,32,629
Milton Keynes 013,E02003471,6565,5766,799,69,641,89,731
Milton Keynes 014,E02003472,8596,6547,2049,192,1511,346,1387
Milton Keynes 015,E02003473,5683,5026,657,68,516,73,608
Milton Keynes 016,E02003474,8643,7395,1248,78,1050,120,926
Milton Keynes 017,E02003475,14877,11876,3001,364,2447,190,1362
Milton Keynes 018,E02003476,8646,7398,1248,151,907,190,1110
Milton Keynes 019,E02003477,11382,9743,1639,155,1316,168,1264
Milton Keynes 020,E02003478,6900,6123,777,63,630,84,712
Milton Keynes 021,E02003479,7436,6250,1186,127,820,239,914
Milton Keynes 022,E02003480,8186,7320,866,88,716,62,827
Milton Keynes 023,E02003481,7133,6250,883,92,706,85,685
Milton Keynes 024,E02003482,6229,5588,641,93,492,56,449
Milton Keynes 025,E02003483,10902,9748,1154,108,903,143,1201
Milton Keynes 026,E02003484,7243,6429,814,48,696,70,646
Milton Keynes 027,E02003485,8062,7336,726,83,613,30,604
Milton Keynes 028,E02003486,8899,7937,962,127,767,68,943
Milton Keynes 029,E02003487,7231,6686,545,45,458,42,594
Milton Keynes 030,E02003488,7059,6301,758,61,648,49,603
Milton Keynes 031,E02003489,6920,6154,766,58,690,18,481
Milton Keynes 032,E02003490,6996,6082,914,128,763,23,579
Portsmouth 001,E02003524,7989,7359,630,133,465,32,605
Portsmouth 002,E02003525,6239,5598,641,87,519,35,649
Portsmouth 003,E02003526,6509,5929,580,31,510,39,436
Portsmouth 004,E02003527,5869,5163,706,49,617,40,582
Portsmouth 006,E02003529,7743,6959,784,61,659,64,544
Portsmouth 007,E02003530,7525,6720,805,78,695,32,697
Portsmouth 008,E02003531,7949,7317,632,55,547,30,536
Portsmouth 009,E02003532,7538,6647,891,90,753,48,866
Portsmouth 010,E02003533,5570,4929,641,72,553,16,595
Portsmouth 011,E02003534,8817,7874,943,97,806,40,920
Portsmouth 012,E02003535,9491,8346,1145,101,972,72,1010
Portsmouth 013,E02003536,7513,6613,900,118,695,87,906
Portsmouth 014,E02003537,10468,9523,945,80,819,46,825
Portsmouth 015,E02003538,10207,8247,1960,202,1613,145,1407
Portsmouth 016,E02003539,12367,8833,3534,290,2859,385,2730
Portsmouth 017,E02003540,9119,7600,1519,87,1243,189,1204
Portsmouth 018,E02003541,11628,7995,3633,413,2986,234,2032
Portsmouth 019,E02003542,9456,6517,2939,245,2509,185,2071
Portsmouth 020,E02003543,8951,5459,3492,311,2986,195,2228
Portsmouth 021,E02003544,6450,5355,1095,56,966,73,844
Portsmouth 022,E02003545,7148,5153,1995,165,1650,180,1421
Portsmouth 023,E02003546,8525,7069,1456,110,1252,94,1059
Portsmouth 024,E02003547,8644,5981,2663,214,2087,362,1848
Portsmouth 025,E02003548,6796,5016,1780,107,1518,155,1380
Portsmouth 026,E02006821,6545,5910,635,96,490,49,610
Reading 001,E02003389,7781,7086,695,93,545,57,597
Reading 002,E02003390,7601,7057,544,69,422,53,595
Reading 003,E02003391,8233,7234,999,137,770,92,747
Reading 004,E02003392,8119,6950,1169,144,932,93,965
Reading 005,E02003393,7830,7163,667,80,537,50,621
Reading 006,E02003394,7536,6777,759,75,630,54,703
Reading 007,E02003395,9453,7478,1975,246,1453,276,1565
Reading 008,E02003396,9210,7745,1465,169,1161,135,1271
Reading 009,E02003397,7444,6845,599,67,502,30,540
Reading 010,E02003398,10517,7412,3105,482,2186,437,2077
Reading 011,E02003399,11836,8201,3635,428,2524,683,2698
Reading 012,E02003400,8463,5205,3258,546,2433,279,1940
Reading 013,E02003401,8306,6802,1504,137,1252,115,1142
Reading 014,E02003402,9543,6401,3142,297,2311,534,2343
Reading 015,E02003403,8548,7695,853,119,654,80,697
Reading 016,E02003404,7888,5124,2764,143,2167,454,1383
Reading 017,E02003405,9931,8433,1498,242,1115,141,1071
Reading 018,E02003406,7459,6821,638,52,539,47,598
Slough 001,E02003407,9376,8519,857,166,636,55,618
Slough 002,E02003408,10334,9122,1212,174,857,181,998
Slough 003,E02003409,10357,9066,1291,152,1017,122,920
Slough 004,E02003410,11450,10172,1278,256,785,237,1065
Slough 005,E02003411,11017,9734,1283,226,845,212,918
Slough 006,E02003412,9447,8451,996,135,794,67,826
Slough 007,E02003413,12364,10462,1902,316,1248,338,1474
Slough 008,E02003414,12116,10250,1866,199,1512,155,1203
Slough 009,E02003415,12117,9893,2224,357,1478,389,1519
Slough 010,E02003416,8079,7012,1067,101,877,89,808
Slough 011,E02003417,9386,7827,1559,169,1167,223,1174
Slough 012,E02003418,9504,8532,972,72,825,75,734
Slough 013,E02003419,8501,7507,994,144,756,94,732
Slough 014,E02003420,6157,5206,951,159,721,71,703
Southampton 001,E02003549,8453,5434,3019,199,2256,564,1961
Southampton 002,E02003550,7878,7217,661,51,572,38,653
Southampton 003,E02003551,6655,4322,2333,61,1808,464,1699
Southampton 004,E02003552,6168,5578,590,50,514,26,554
Southampton 005,E02003553,7009,4840,2169,215,1623,331,1501
Southampton 006,E02003554,6079,5158,921,56,763,102,787
Southampton 007,E02003555,7325,6587,738,61,645,32,648
Southampton 008,E02003556,5941,5444,497,52,411,34,499
Southampton 009,E02003557,6897,4651,2246,246,1713,287,1659
Southampton 010,E02003558,6612,5543,1069,144,828,97,883
Southampton 011,E02003559,7813,6992,821,68,643,110,862
Southampton 012,E02003560,7165,6435,730,132,572,26,604
Southampton 013,E02003561,7934,5260,2674,288,2202,184,1665
Southampton 014,E02003562,8085,6883,1202,112,973,117,1019
Southampton 015,E02003563,7717,6619,1098,128,889,81,958
Southampton 016,E02003564,8000,7245,755,64,650,41,686
Southampton 017,E02003565,6622,3589,3033,428,2403,202,2031
Southampton 018,E02003566,6035,5567,468,50,381,37,512
Southampton 019,E02003567,7665,6866,799,50,690,59,735
Southampton 020,E02003568,8509,5924,2585,197,2090,298,1870
Southampton 021,E02003569,7428,5920,1508,159,1205,144,1116
Southampton 022,E02003570,10222,7485,2737,507,1834,396,1839
Southampton 023,E02003571,7164,3592,3572,589,2769,214,2015
Southampton 024,E02003572,6127,5543,584,40,498,46,536
Southampton 025,E02003573,7452,6840,612,80,506,26,569
Southampton 026,E02003574,7757,7109,648,41,571,36,673
Southampton 027,E02003575,6348,5711,637,83,540,14,606
Southampton 028,E02003576,8076,7133,943,86,808,49,831
Southampton 029,E02003577,11598,6613,4985,533,3944,508,3173
Southampton 030,E02003578,6296,5694,602,43,537,22,578
Southampton 031,E02003579,7822,6872,950,104,801,45,834
Southampton 032,E02003580,6030,5531,499,115,361,23,469
West Berkshire 001,E02003367,6262,5663,599,92,478,29,596
West Berkshire 002,E02003368,5575,5025,550,114,404,32,430
West Berkshire 003,E02003369,6081,5392,689,119,501,69,516
West Berkshire 004,E02003370,6548,6068,480,52,380,48,535
West Berkshire 005,E02003371,5945,5618,327,22,280,25,369
West Berkshire 006,E02003372,7657,7134,523,52,444,27,564
West Berkshire 007,E02003373,8623,7766,857,113,649,95,736
West Berkshire 008,E02003374,5728,5264,464,46,401,17,507
West Berkshire 009,E02003375,5788,5210,578,84,454,40,451
West Berkshire 010,E02003376,5767,5122,645,196,408,41,404
West Berkshire 011,E02003377,10236,9093,1143,117,898,128,886
West Berkshire 012,E02003378,7725,6810,915,97,745,73,697
West Berkshire 013,E02003379,6827,5977,850,96,676,78,658
West Berkshire 014,E02003380,7851,7279,572,86,467,19,607
West Berkshire 015,E02003381,5955,5398,557,86,440,31,477
West Berkshire 016,E02003382,7585,6849,736,129,554,53,588
West Berkshire 017,E02003383,6918,6308,610,85,494,31,544
West Berkshire 018,E02003384,6385,5678,707,104,536,67,636
West Berkshire 019,E02003385,7536,6266,1270,149,1000,121,969
West Berkshire 020,E02003386,7965,6989,976,126,803,47,759
West Berkshire 021,E02003387,9133,8271,862,131,672,59,718
West Berkshire 022,E02003388,5732,5160,572,82,425,65,383
Windsor and Maidenhead 001,E02003421,5590,5105,485,45,389,51,450
Windsor and Maidenhead 002,E02003422,11490,10315,1175,162,878,135,977
Windsor and Maidenhead 003,E02003423,6067,5503,564,51,455,58,515
Windsor and Maidenhead 004,E02003424,8116,7067,1049,93,795,161,815
Windsor and Maidenhead 005,E02003425,10853,9083,1770,254,1332,184,1267
Windsor and Maidenhead 006,E02003426,9586,8475,1111,121,867,123,916
Windsor and Maidenhead 007,E02003427,7540,6657,883,121,666,96,667
Windsor and Maidenhead 008,E02003428,9022,8266,756,107,596,53,703
Windsor and Maidenhead 009,E02003429,7483,6701,782,87,623,72,608
Windsor and Maidenhead 010,E02003430,6713,5504,1209,132,927,150,774
Windsor and Maidenhead 011,E02003431,6596,5883,713,86,555,72,619
Windsor and Maidenhead 012,E02003432,6758,5585,1173,120,941,112,914
Windsor and Maidenhead 013,E02003433,6614,5892,722,136,518,68,670
Windsor and Maidenhead 014,E02003434,8773,7666,1107,168,840,99,717
Windsor and Maidenhead 015,E02003435,6911,5980,931,103,663,165,771
Windsor and Maidenhead 016,E02003436,8357,7622,735,122,547,66,649
Windsor and Maidenhead 017,E02003437,7516,6371,1145,81,853,211,829
Windsor and Maidenhead 018,E02003438,10575,9202,1373,200,925,248,938
Wokingham 001,E02003439,5421,4883,538,99,407,32,477
Wokingham 002,E02003440,8833,7943,890,202,623,65,626
Wokingham 003,E02003441,7634,6999,635,69,518,48,553
Wokingham 004,E02003442,7107,6485,622,71,501,50,676
Wokingham 005,E02003443,5974,5392,582,56,490,36,431
Wokingham 006,E02003444,8890,7947,943,72,790,81,899
Wokingham 007,E02003445,8331,7279,1052,90,881,81,890
Wokingham 008,E02003446,8488,7480,1008,85,781,142,1504
Wokingham 009,E02003447,9438,8344,1094,98,923,73,816
Wokingham 010,E02003448,6672,6042,630,44,549,37,556
Wokingham 011,E02003449,7464,6497,967,139,773,55,797
Wokingham 012,E02003450,10638,9148,1490,188,1164,138,1105
Wokingham 013,E02003451,7939,6917,1022,168,784,70,792
Wokingham 014,E02003452,6100,5608,492,54,405,33,451
Wokingham 015,E02003453,6512,5953,559,44,469,46,531
Wokingham 016,E02003454,7612,6803,809,95,616,98,607
Wokingham 017,E02003455,6715,5994,721,96,576,49,601
Wokingham 018,E02003456,6824,5799,1025,64,857,104,1089
Wokingham 019,E02003457,9764,9025,739,105,545,89,686
Wokingham 020,E02003458,8024,7281,743,85,585,73,613
Aylesbury Vale 001,E02003652,8623,7535,1088,173,762,153,726
Aylesbury Vale 002,E02003653,6469,5331,1138,202,737,199,558
Aylesbury Vale 003,E02003654,5531,5115,416,73,320,23,381
Aylesbury Vale 004,E02003655,9456,8619,837,108,693,36,755
Aylesbury Vale 005,E02003656,5725,5205,520,114,386,20,468
Aylesbury Vale 006,E02003657,6053,5542,511,53,412,46,455
Aylesbury Vale 007,E02003658,7041,6521,520,64,436,20,505
Aylesbury Vale 008,E02003659,8334,7320,1014,108,875,31,586
Aylesbury Vale 009,E02003660,9544,8737,807,131,639,37,705
Aylesbury Vale 010,E02003661,5750,4978,772,80,643,49,518
Aylesbury Vale 011,E02003662,6266,5607,659,80,541,38,609
Aylesbury Vale 012,E02003663,5478,4993,485,41,426,18,505
Aylesbury Vale 013,E02003664,6187,5408,779,76,665,38,705
Aylesbury Vale 014,E02003665,5896,5158,738,51,652,35,553
Aylesbury Vale 015,E02003666,6723,5537,1186,132,948,106,774
Aylesbury Vale 016,E02003667,9398,8147,1251,246,916,89,1103
Aylesbury Vale 017,E02003668,8804,8090,714,71,600,43,636
Aylesbury Vale 018,E02003669,6912,6167,745,119,549,77,586
Aylesbury Vale 019,E02003670,8726,7545,1181,112,963,106,791
Aylesbury Vale 020,E02003671,5882,5283,599,79,487,33,573
Aylesbury Vale 021,E02003672,9641,8863,778,104,636,38,753
Aylesbury Vale 022,E02003673,8105,7371,734,113,578,43,627
Aylesbury Vale 023,E02003674,5259,4843,416,73,302,41,366
Aylesbury Vale 024,E02003675,8334,7142,1192,219,886,87,973
Chiltern 001,E02003676,8015,7410,605,48,525,32,622
Chiltern 002,E02003677,9593,8732,861,155,630,76,696
Chiltern 003,E02003678,5518,5031,487,48,406,33,537
Chiltern 004,E02003679,6372,5565,807,109,642,56,567
Chiltern 005,E02003680,10072,9238,834,139,620,75,768
Chiltern 006,E02003681,10172,9013,1159,217,840,102,741
Chiltern 007,E02003682,7329,6539,790,97,631,62,800
Chiltern 008,E02003683,6292,5643,649,70,530,49,504
Chiltern 010,E02003685,7957,7203,754,165,512,77,618
Chiltern 011,E02003686,7068,6479,589,99,412,78,566
Chiltern 012,E02003687,5698,5184,514,55,403,56,456
Chiltern 013,E02006823,8549,7890,659,76,522,61,649
South Bucks 001,E02003688,12081,10415,1666,304,1110,252,1057
South Bucks 002,E02003689,8693,7708,985,121,653,211,787
South Bucks 003,E02003690,6463,5824,639,61,511,67,563
South Bucks 004,E02003691,6857,6213,644,100,491,53,588
South Bucks 005,E02003692,8476,7681,795,58,638,99,670
South Bucks 006,E02003693,6205,5591,614,52,505,57,532
South Bucks 007,E02003694,7846,7099,747,99,622,26,596
South Bucks 008,E02003695,10246,9324,922,136,710,76,665
Wycombe 001,E02003696,8101,7276,825,159,616,50,525
Wycombe 002,E02003697,6052,5436,616,47,515,54,529
Wycombe 003,E02003698,8362,7666,696,58,582,56,743
Wycombe 004,E02003699,5554,5030,524,110,388,26,389
Wycombe 006,E02003701,11169,9843,1326,198,1039,89,922
Wycombe 007,E02003702,8286,7363,923,60,777,86,883
Wycombe 008,E02003703,7835,6457,1378,73,1186,119,1080
Wycombe 009,E02003704,5919,5380,539,68,440,31,509
Wycombe 010,E02003705,6920,5845,1075,100,888,87,792
Wycombe 011,E02003706,6562,5834,728,25,668,35,623
Wycombe 012,E02003707,6214,5387,827,58,722,47,602
Wycombe 013,E02003708,9406,8011,1395,259,965,171,1036
Wycombe 014,E02003709,5807,5099,708,52,610,46,586
Wycombe 015,E02003710,10365,8181,2184,211,1741,232,1406
Wycombe 016,E02003711,8486,6977,1509,125,1293,91,1081
Wycombe 017,E02003712,7825,7129,696,63,583,50,629
Wycombe 018,E02003713,5965,5491,474,64,378,32,401
Wycombe 019,E02003714,6627,5974,653,74,545,34,589
Wycombe 020,E02003715,6710,6105,605,67,463,75,595
Wycombe 021,E02003716,5531,4932,599,66,490,43,453
Wycombe 022,E02003717,8799,7864,935,146,696,93,725
Wycombe 023,E02003718,5526,4777,749,83,598,68,538
Wycombe 024,E02006824,9623,8903,720,81,593,46,698
Eastbourne 001,E02004356,7492,6836,656,98,528,30,673
Eastbourne 002,E02004357,7695,7073,622,95,518,9,563
Eastbourne 003,E02004358,7779,7212,567,50,499,18,490
Eastbourne 004,E02004359,7938,7247,691,59,601,31,575
Eastbourne 006,E02004361,7984,7299,685,45,597,43,601
Eastbourne 007,E02004362,8723,7767,956,83,827,46,806
Eastbourne 008,E02004363,6728,5492,1236,87,1043,106,829
Eastbourne 009,E02004364,8214,7159,1055,131,877,47,828
Eastbourne 010,E02004365,7420,5432,1988,378,1451,159,1297
Eastbourne 011,E02004366,6898,5069,1829,181,1508,140,1133
Eastbourne 012,E02004367,7070,5717,1353,126,1088,139,935
Eastbourne 013,E02006857,8500,7591,909,97,766,46,682
Eastbourne 014,E02006858,6971,5667,1304,154,1076,74,962
Hastings 001,E02004368,8042,7221,821,128,650,43,717
Hastings 002,E02004369,9682,8893,789,63,695,31,676
Hastings 003,E02004370,7706,6893,813,128,675,10,726
Hastings 004,E02004371,7022,6123,899,176,699,24,649
Hastings 005,E02004372,6495,5734,761,98,640,23,659
Hastings 006,E02004373,8548,7639,909,105,782,22,756
Hastings 007,E02004374,7746,6783,963,136,774,53,749
Hastings 008,E02004375,8552,7082,1470,141,1243,86,1107
Hastings 009,E02004376,6987,5442,1545,202,1273,70,1102
Hastings 010,E02004377,10580,9179,1401,165,1182,54,1189
Hastings 011,E02004378,8894,6391,2503,467,1873,163,1264
Lewes 001,E02004379,7650,6914,736,141,542,53,504
Lewes 002,E02004380,8786,7908,878,75,741,62,755
Lewes 003,E02004381,9595,8485,1110,268,757,85,798
Lewes 004,E02004382,6422,5955,467,73,362,32,426
Lewes 005,E02004383,7702,6814,888,123,690,75,633
Lewes 006,E02004384,7477,6872,605,74,505,26,558
Lewes 007,E02004385,7590,6877,713,125,572,16,526
Lewes 008,E02004386,6286,5652,634,93,496,45,471
Lewes 009,E02004387,5946,5296,650,134,479,37,527
Lewes 010,E02004388,6477,5744,733,90,619,24,459
Lewes 011,E02004389,9480,8686,794,144,624,26,631
Lewes 012,E02004390,7853,7184,669,108,525,36,499
Lewes 013,E02004391,6238,5381,857,190,631,36,675
Rother 001,E02004392,9281,8430,851,156,634,61,743
Rother 002,E02004393,6129,5543,586,76,476,34,490
Rother 003,E02004394,7826,7094,732,121,550,61,581
Rother 004,E02004395,7584,6762,822,253,531,38,546
Rother 005,E02004396,8663,7843,820,83,657,80,710
Rother 006,E02004397,7998,7044,954,215,670,69,660
Rother 007,E02004398,8736,7775,961,204,718,39,851
Rother 008,E02004399,7757,6889,868,108,718,42,492
Rother 009,E02004400,10232,9220,1012,132,832,48,785
Rother 010,E02004401,7672,6911,761,72,655,34,568
Rother 011,E02004402,8710,7117,1593,373,1145,75,904
Wealden 001,E02004403,6483,5808,675,116,462,97,508
Wealden 002,E02004404,6421,5822,599,56,498,45,568
Wealden 003,E02004405,5801,5073,728,62,628,38,390
Wealden 004,E02004406,7168,6458,710,83,567,60,568
Wealden 005,E02004407,7795,6873,922,191,637,94,619
Wealden 006,E02004408,7982,7300,682,104,517,61,671
Wealden 007,E02004409,5588,5032,556,47,453,56,447
Wealden 008,E02004410,7824,7044,780,105,624,51,686
Wealden 009,E02004411,8511,7639,872,223,611,38,678
Wealden 010,E02004412,7772,6930,842,247,563,32,633
Wealden 011,E02004413,6831,6279,552,74,453,25,500
Wealden 012,E02004414,5982,5287,695,115,542,38,492
Wealden 013,E02004415,6149,5373,776,88,659,29,492
Wealden 014,E02004416,6441,5862,579,118,412,49,473
Wealden 015,E02004417,5630,5029,601,83,482,36,392
Wealden 016,E02004418,5525,4997,528,71,437,20,425
Wealden 017,E02004419,5931,5395,536,90,419,27,473
Wealden 018,E02004420,10519,9304,1215,102,1016,97,750
Wealden 019,E02004421,7655,6918,737,101,608,28,541
Wealden 020,E02004422,9467,8538,929,153,719,57,640
Wealden 021,E02004423,7440,6887,553,29,486,38,371
Basingstoke and Deane 001,E02004675,7417,6849,568,138,406,24,505
Basingstoke and Deane 002,E02004676,8007,7351,656,132,487,37,559
Basingstoke and Deane 003,E02004677,7239,6552,687,117,505,65,561
Basingstoke and Deane 004,E02004678,7423,6666,757,153,564,40,576
Basingstoke and Deane 005,E02004679,8424,7447,977,114,803,60,572
Basingstoke and Deane 006,E02004680,6806,5821,985,108,821,56,703
Basingstoke and Deane 007,E02004681,11249,9507,1742,246,1366,130,879
Basingstoke and Deane 008,E02004682,7898,6928,970,99,802,69,863
Basingstoke and Deane 009,E02004683,6898,6056,842,73,702,67,677
Basingstoke and Deane 010,E02004684,9141,7920,1221,124,1055,42,783
Basingstoke and Deane 011,E02004685,6950,5747,1203,123,921,159,855
Basingstoke and Deane 012,E02004686,7985,6500,1485,191,1098,196,996
Basingstoke and Deane 013,E02004687,7075,6250,825,98,704,23,686
Basingstoke and Deane 014,E02004688,7679,6853,826,83,688,55,675
Basingstoke and Deane 015,E02004689,5476,5077,399,62,323,14,383
Basingstoke and Deane 016,E02004690,7873,7083,790,77,652,61,678
Basingstoke and Deane 017,E02004691,7818,7076,742,73,613,56,636
Basingstoke and Deane 018,E02004692,7285,6875,410,38,346,26,419
Basingstoke and Deane 019,E02004693,7164,6422,742,97,595,50,656
Basingstoke and Deane 020,E02004694,6748,6118,630,151,448,31,455
Basingstoke and Deane 021,E02004695,8971,8029,942,136,733,73,843
Basingstoke and Deane 022,E02004696,6273,5640,633,126,468,39,399
East Hampshire 001,E02004697,5856,5200,656,57,539,60,561
East Hampshire 002,E02004698,5565,4787,778,139,572,67,526
East Hampshire 003,E02004699,10633,9518,1115,277,764,74,806
East Hampshire 004,E02004700,5858,4689,1169,96,902,171,1038
East Hampshire 006,E02004702,8199,7415,784,169,554,61,641
East Hampshire 007,E02004703,10669,9709,960,157,733,70,747
East Hampshire 008,E02004704,5672,5167,505,49,416,40,843
East Hampshire 009,E02004705,8491,7558,933,146,730,57,731
East Hampshire 010,E02004706,7583,6778,805,139,627,39,555
East Hampshire 011,E02004707,11539,10321,1218,233,879,106,963
East Hampshire 012,E02004708,8621,7561,1060,282,719,59,793
East Hampshire 013,E02004709,7388,6918,470,71,353,46,460
East Hampshire 014,E02004710,6387,5816,571,54,476,41,568
East Hampshire 016,E02006829,6551,5983,568,43,485,40,459
East Hampshire 017,E02006838,6596,5954,642,79,496,67,441
Eastleigh 001,E02004712,8801,7993,808,90,682,36,613
Eastleigh 002,E02004713,7845,7208,637,60,556,21,592
Eastleigh 003,E02004714,7705,6795,910,115,756,39,602
Eastleigh 004,E02004715,8055,7202,853,77,748,28,749
Eastleigh 005,E02004716,8816,8006,810,140,647,23,583
Eastleigh 006,E02004717,9682,8298,1384,177,1151,56,838
Eastleigh 007,E02004718,8883,7487,1396,213,1119,64,1046
Eastleigh 008,E02004719,10081,9380,701,108,561,32,651
Eastleigh 009,E02004720,10761,9752,1009,112,843,54,868
Eastleigh 010,E02004721,9233,8158,1075,189,844,42,705
Eastleigh 011,E02004722,7221,6639,582,57,502,23,520
Eastleigh 012,E02004723,9419,8634,785,121,640,24,637
Eastleigh 013,E02004724,7664,6976,688,90,551,47,651
Eastleigh 014,E02004725,5332,4684,648,144,472,32,396
Eastleigh 015,E02004726,5701,5007,694,151,488,55,402
Fareham 001,E02004727,9013,8160,853,93,720,40,661
Fareham 002,E02004728,8559,7632,927,95,774,58,774
Fareham 003,E02004729,7401,6749,652,90,537,25,605
Fareham 004,E02004730,8740,8056,684,71,580,33,677
Fareham 005,E02004731,7900,7169,731,70,580,81,610
Fareham 006,E02004732,8168,7322,846,105,669,72,674
Fareham 007,E02004733,7364,6403,961,96,819,46,564
Fareham 008,E02004734,10202,8977,1225,175,1000,50,918
Fareham 009,E02004735,7518,6925,593,68,478,47,588
Fareham 010,E02004736,7847,7340,507,63,419,25,490
Fareham 011,E02004737,7430,6543,887,140,703,44,676
Fareham 012,E02004738,7362,6757,605,80,495,30,438
Fareham 013,E02004739,6907,6344,563,84,455,24,587
Fareham 014,E02004740,7170,6605,565,80,431,54,575
Gosport 001,E02004741,7755,7248,507,56,425,26,483
Gosport 002,E02004742,7494,6865,629,57,541,31,602
Gosport 003,E02004743,7631,6933,698,88,596,14,648
Gosport 004,E02004744,8667,7433,1234,238,951,45,1199
Gosport 005,E02004745,9024,7764,1260,231,977,52,982
Gosport 006,E02004746,10860,9623,1237,251,888,98,757
Gosport 007,E02004747,6591,5832,759,73,643,43,859
Gosport 008,E02004748,9594,7807,1787,289,1427,71,1055
Gosport 009,E02004749,7149,6443,706,100,552,54,568
Gosport 010,E02004750,7857,6933,924,100,794,30,733
Hart 001,E02004751,8164,7514,650,103,507,40,548
Hart 002,E02004752,8318,7689,629,78,510,41,662
Hart 003,E02004753,10115,9348,767,70,627,70,949
Hart 004,E02004754,6054,5517,537,82,416,39,467
Hart 005,E02004755,11608,10038,1570,314,1054,202,1165
Hart 006,E02004756,8334,7592,742,148,524,70,676
Hart 007,E02004757,8057,7419,638,44,521,73,596
Hart 008,E02004758,7884,7091,793,65,658,70,624
Hart 009,E02004759,8107,7373,734,70,618,46,621
Hart 010,E02004760,7751,6741,1010,96,800,114,959
Hart 011,E02004761,6641,5565,1076,149,847,80,1001
Havant 003,E02004764,7850,7322,528,30,477,21,517
Havant 004,E02004765,6016,5490,526,45,438,43,555
Havant 005,E02004766,6424,5802,622,28,564,30,542
Havant 006,E02004767,5896,5308,588,70,514,4,459
Havant 007,E02004768,5591,5073,518,49,431,38,474
Havant 008,E02004769,6407,5802,605,74,520,11,544
Havant 009,E02004770,6910,6228,682,79,589,14,629
Havant 010,E02004771,8968,8078,890,100,761,29,733
Havant 011,E02004772,9171,8435,736,102,595,39,642
Havant 013,E02004774,9492,8546,946,175,716,55,702
Havant 014,E02004775,8882,8023,859,80,723,56,713
Havant 015,E02004776,5977,5480,497,76,388,33,518
Havant 016,E02004777,5384,4738,646,78,539,29,413
Havant 017,E02004778,6018,5309,709,130,533,46,449
Havant 018,E02006822,8763,8012,751,44,663,44,648
Havant 019,E02006830,6711,6036,675,96,556,23,573
Havant 020,E02006831,6224,5780,444,43,378,23,439
New Forest 001,E02004779,10876,9822,1054,291,710,53,713
New Forest 002,E02004780,6023,5564,459,45,390,24,438
New Forest 003,E02004781,8258,7436,822,109,681,32,644
New Forest 004,E02004782,7650,6862,788,104,653,31,606
New Forest 005,E02004783,7039,6373,666,90,542,34,610
New Forest 006,E02004784,5764,5291,473,50,398,25,380
New Forest 007,E02004785,5544,4870,674,156,464,54,403
New Forest 008,E02004786,8817,7791,1026,200,735,91,880
New Forest 009,E02004787,7377,6659,718,118,565,35,507
New Forest 010,E02004788,7195,6514,681,158,484,39,563
New Forest 011,E02004789,10473,9521,952,226,682,44,671
New Forest 012,E02004790,7688,6830,858,199,625,34,540
New Forest 013,E02004791,5602,5105,497,76,402,19,424
New Forest 014,E02004792,8685,8021,664,122,502,40,668
New Forest 015,E02004793,7433,6582,851,166,581,104,537
New Forest 016,E02004794,6919,6270,649,126,469,54,561
New Forest 017,E02004795,8426,7258,1168,225,851,92,772
New Forest 018,E02004796,9641,8786,855,110,694,51,607
New Forest 019,E02004797,7853,6924,929,246,632,51,658
New Forest 020,E02004798,6135,5485,650,112,510,28,487
New Forest 021,E02004799,7960,6950,1010,162,785,63,658
New Forest 022,E02004800,7457,6718,739,71,638,30,506
New Forest 023,E02004801,7647,6810,837,166,628,43,534
Rushmoor 001,E02004802,6854,6066,788,104,607,77,635
Rushmoor 002,E02004803,7552,6668,884,190,535,159,668
Rushmoor 003,E02004804,7213,6616,597,44,498,55,551
Rushmoor 004,E02004805,8260,7218,1042,70,893,79,700
Rushmoor 005,E02004806,8173,7366,807,44,685,78,704
Rushmoor 006,E02004807,9052,7968,1084,133,847,104,829
Rushmoor 007,E02004808,10382,8467,1915,253,1473,189,1494
Rushmoor 008,E02004809,8816,6167,2649,243,1959,447,1748
Rushmoor 009,E02004810,7539,6674,865,120,656,89,876
Rushmoor 010,E02004811,7449,6362,1087,161,756,170,734
Rushmoor 011,E02004812,6474,5782,692,67,526,99,613
Rushmoor 012,E02004813,6043,5491,552,22,499,31,452
Test Valley 001,E02004814,7043,6418,625,78,509,38,598
Test Valley 002,E02004815,7623,6843,780,220,511,49,653
Test Valley 003,E02004816,9139,7639,1500,184,1256,60,668
Test Valley 004,E02004817,7762,6823,939,124,737,78,801
Test Valley 005,E02004818,10164,8978,1186,123,970,93,1006
Test Valley 006,E02004819,7898,6973,925,103,778,44,747
Test Valley 007,E02004820,7371,6258,1113,109,878,126,926
Test Valley 008,E02004821,5238,4684,554,88,414,52,488
Test Valley 009,E02004822,7898,7111,787,113,597,77,648
Test Valley 010,E02004823,8969,8200,769,141,590,38,603
Test Valley 011,E02004824,5799,5121,678,118,517,43,487
Test Valley 012,E02004825,10631,9660,971,137,779,55,769
Test Valley 013,E02004826,6809,6160,649,70,519,60,600
Test Valley 014,E02004827,7713,7021,692,149,483,60,604
Test Valley 015,E02004828,6341,5820,521,54,418,49,474
Winchester 001,E02004829,5644,4825,819,100,631,88,620
Winchester 002,E02004830,6331,5633,698,81,561,56,565
Winchester 003,E02004831,8784,7753,1031,86,856,89,869
Winchester 004,E02004832,8630,7724,906,242,588,76,567
Winchester 005,E02004833,9725,7680,2045,212,1658,175,1671
Winchester 006,E02004834,7446,5906,1540,238,1121,181,993
Winchester 007,E02004835,10086,7678,2408,372,1783,253,1470
Winchester 008,E02004836,6336,4446,1890,355,1454,81,1049
Winchester 009,E02004837,7594,6656,938,108,783,47,853
Winchester 010,E02004838,9053,8122,931,112,744,75,812
Winchester 011,E02004839,8151,7487,664,82,539,43,657
Winchester 012,E02004840,9459,8560,899,214,644,41,723
Winchester 013,E02004841,11131,9793,1338,180,1081,77,1046
Winchester 014,E02004842,8225,7197,1028,173,811,44,688
Ashford 001,E02004996,7956,7109,847,142,642,63,654
Ashford 002,E02004997,7545,6908,637,82,527,28,475
Ashford 003,E02004998,6680,6072,608,64,506,38,568
Ashford 004,E02004999,12536,10814,1722,249,1307,166,1133
Ashford 005,E02005000,9580,8080,1500,183,1146,171,1119
Ashford 006,E02005001,8890,8056,834,119,638,77,688
Ashford 007,E02005002,8958,7874,1084,171,836,77,960
Ashford 008,E02005003,8553,7328,1225,185,969,71,804
Ashford 009,E02005004,12098,10589,1509,233,1164,112,1064
Ashford 010,E02005005,7432,6618,814,86,687,41,517
Ashford 011,E02005006,5459,5079,380,79,280,21,396
Ashford 012,E02005007,8552,7694,858,79,743,36,722
Ashford 013,E02005008,8110,7385,725,193,481,51,499
Ashford 014,E02005009,5607,5172,435,53,354,28,424
Canterbury 001,E02005010,7470,6273,1197,291,850,56,698
Canterbury 002,E02005011,7353,6805,548,69,456,23,451
Canterbury 003,E02005012,8682,7912,770,99,617,54,622
Canterbury 004,E02005013,8147,7397,750,69,645,36,616
Canterbury 005,E02005014,8463,7877,586,70,487,29,556
Canterbury 006,E02005015,8440,7655,785,118,629,38,627
Canterbury 007,E02005016,7748,7052,696,81,569,46,677
Canterbury 008,E02005017,7208,6208,1000,198,752,50,723
Canterbury 009,E02005018,7945,7370,575,53,484,38,527
Canterbury 010,E02005019,6020,5419,601,69,484,48,447
Canterbury 011,E02005020,7129,6445,684,95,529,60,575
Canterbury 012,E02005021,10478,5747,4731,280,3391,1060,3120
Canterbury 013,E02005022,8317,5333,2984,503,2302,179,1628
Canterbury 014,E02005023,8971,5795,3176,553,2288,335,1697
Canterbury 016,E02005025,9015,6503,2512,240,1904,368,1589
Canterbury 017,E02005026,7430,6672,758,110,588,60,622
Canterbury 018,E02005027,5515,5012,503,58,406,39,393
Canterbury 019,E02006855,5941,4365,1576,144,1288,144,1047
Canterbury 020,E02006856,10873,7537,3336,423,2548,365,1972
Dartford 001,E02005028,7404,6666,738,66,621,51,576
Dartford 002,E02005029,9352,7836,1516,134,1303,79,1008
Dartford 003,E02005030,9811,8579,1232,162,951,119,1008
Dartford 004,E02005031,7468,6581,887,97,740,50,721
Dartford 005,E02005032,8962,7822,1140,139,922,79,913
Dartford 006,E02005033,6553,5791,762,78,648,36,639
Dartford 007,E02005034,7666,7149,517,48,446,23,518
Dartford 008,E02005035,7999,7300,699,58,540,101,571
Dartford 009,E02005036,6307,5729,578,54,484,40,507
Dartford 010,E02005037,7012,6494,518,35,461,22,467
Dartford 011,E02005038,5793,5398,395,23,349,23,313
Dartford 012,E02005039,6792,6226,566,52,486,28,413
Dartford 013,E02005040,6246,5739,507,57,420,30,476
Dover 001,E02005041,7011,6386,625,155,443,27,503
Dover 002,E02005042,8957,8104,853,170,601,82,657
Dover 003,E02005043,7445,6646,799,123,627,49,593
Dover 004,E02005044,6847,5770,1077,149,818,110,705
Dover 005,E02005045,7988,7336,652,92,529,31,580
Dover 006,E02005046,6498,5884,614,145,404,65,476
Dover 007,E02005047,7610,6853,757,119,607,31,627
Dover 008,E02005048,6531,6025,506,45,432,29,488
Dover 009,E02005049,6929,6336,593,105,455,33,432
Dover 010,E02005050,9126,8261,865,123,668,74,551
Dover 011,E02005051,13316,11637,1679,545,1095,39,1137
Dover 012,E02005052,7884,6558,1326,190,985,151,905
Dover 013,E02005053,8901,7473,1428,341,987,100,992
Dover 014,E02005054,6631,6129,502,68,409,25,468
Gravesham 001,E02005055,7803,6778,1025,106,824,95,875
Gravesham 002,E02005056,10022,8176,1846,397,1175,274,1112
Gravesham 003,E02005057,10609,9375,1234,118,975,141,1027
Gravesham 004,E02005058,7717,6907,810,83,642,85,715
Gravesham 005,E02005059,9908,9070,838,65,704,69,688
Gravesham 006,E02005060,7364,6661,703,51,626,26,339
Gravesham 007,E02005061,7126,6581,545,38,463,44,609
Gravesham 008,E02005062,6982,6565,417,40,354,23,418
Gravesham 009,E02005063,6606,6100,506,43,445,18,411
Gravesham 010,E02005064,6672,6182,490,40,406,44,401
Gravesham 011,E02005065,7221,6649,572,98,455,19,504
Gravesham 012,E02005066,7794,7263,531,99,408,24,461
Gravesham 013,E02005067,5896,5486,410,48,337,25,431
Maidstone 001,E02005068,7042,6501,541,15,495,31,522
Maidstone 002,E02005069,8569,7685,884,90,716,78,739
Maidstone 003,E02005070,8593,8060,533,94,398,41,463
Maidstone 004,E02005071,10403,8209,2194,216,1744,234,1490
Maidstone 005,E02005072,7623,7034,589,86,467,36,613
Maidstone 006,E02005073,10603,8602,2001,265,1500,236,1594
Maidstone 007,E02005074,7979,7263,716,117,565,34,594
Maidstone 008,E02005075,9461,8236,1225,176,946,103,897
Maidstone 009,E02005076,8579,7358,1221,80,1064,77,861
Maidstone 010,E02005077,7831,7167,664,64,551,49,517
Maidstone 011,E02005078,7928,7312,616,104,478,34,588
Maidstone 012,E02005079,7870,7226,644,65,543,36,480
Maidstone 013,E02005080,11004,9850,1154,191,909,54,845
Maidstone 014,E02005081,6599,6081,518,43,429,46,576
Maidstone 015,E02005082,9543,8460,1083,82,942,59,741
Maidstone 016,E02005083,6741,6230,511,35,443,33,432
Maidstone 017,E02005084,6443,5696,747,83,598,66,493
Maidstone 018,E02005085,6385,5909,476,69,379,28,521
Maidstone 019,E02005086,5947,5477,470,99,345,26,406
Sevenoaks 001,E02005087,6972,6518,454,55,378,21,474
Sevenoaks 002,E02005088,8998,8190,808,214,570,24,593
Sevenoaks 003,E02005089,6257,5815,442,57,360,25,413
Sevenoaks 004,E02005090,5835,5463,372,39,315,18,378
Sevenoaks 005,E02005091,6625,6074,551,56,464,31,431
Sevenoaks 007,E02005093,6062,5648,414,59,326,29,347
Sevenoaks 008,E02005094,8457,7554,903,107,721,75,704
Sevenoaks 009,E02005095,7420,6816,604,92,473,39,471
Sevenoaks 010,E02005096,9508,8423,1085,150,824,111,869
Sevenoaks 011,E02005097,9395,8463,932,110,726,96,753
Sevenoaks 012,E02005098,9791,8408,1383,204,924,255,985
Sevenoaks 013,E02005099,7781,7050,731,126,547,58,596
Sevenoaks 014,E02005100,8907,8161,746,193,525,28,496
Sevenoaks 015,E02005101,6720,6081,639,89,478,72,647
Sevenoaks 016,E02006832,6165,5633,532,189,316,27,390
Shepway 001,E02005102,6275,5767,508,65,387,56,447
Shepway 002,E02005103,9524,8301,1223,197,938,88,685
Shepway 003,E02005104,8348,7681,667,83,555,29,794
Shepway 004,E02005105,7745,6590,1155,226,900,29,914
Shepway 005,E02005106,9093,8025,1068,161,738,169,760
Shepway 006,E02005107,12263,10734,1529,303,1126,100,1214
Shepway 008,E02005109,6562,5851,711,141,529,41,392
Shepway 009,E02005110,6772,6219,553,50,483,20,509
Shepway 010,E02005111,7260,6363,897,261,594,42,552
Shepway 011,E02005112,6946,6444,502,91,391,20,443
Shepway 012,E02005113,6996,6302,694,175,481,38,510
Shepway 013,E02005114,6567,5924,643,136,489,18,393
Shepway 014,E02006879,6698,4934,1764,305,1357,102,921
Shepway 015,E02006880,6920,5354,1566,217,1235,114,810
Swale 001,E02005115,5842,4865,977,264,640,73,639
Swale 002,E02005116,6096,5344,752,166,573,13,541
Swale 003,E02005117,5889,5364,525,66,447,12,472
Swale 004,E02005118,9097,7989,1108,192,896,20,607
Swale 005,E02005119,5702,5206,496,128,345,23,401
Swale 006,E02005120,7665,6493,1172,136,996,40,885
Swale 007,E02005121,12384,11142,1242,196,983,63,965
Swale 008,E02005122,6958,6491,467,75,381,11,395
Swale 009,E02005123,10927,9715,1212,213,953,46,966
Swale 010,E02005124,8239,7149,1090,219,815,56,988
Swale 011,E02005125,7541,6796,745,116,606,23,555
Swale 012,E02005126,7723,7094,629,73,527,29,569
Swale 013,E02005127,8719,7909,810,74,706,30,603
Swale 014,E02005128,8300,7609,691,110,543,38,551
Swale 015,E02005129,11016,9863,1153,323,784,46,704
Swale 016,E02005130,8111,7438,673,95,535,43,563
Swale 017,E02005131,5626,5132,494,63,380,51,421
Thanet 001,E02005132,9553,6969,2584,745,1561,278,1257
Thanet 002,E02005133,8415,7573,842,116,665,61,622
Thanet 003,E02005134,7174,5991,1183,182,946,55,895
Thanet 004,E02005135,7698,6630,1068,97,909,62,782
Thanet 005,E02005136,7844,7189,655,78,552,25,538
Thanet 006,E02005137,7769,7056,713,137,545,31,591
Thanet 007,E02005138,8453,7363,1090,170,864,56,664
Thanet 008,E02005139,8504,7669,835,196,600,39,547
Thanet 009,E02005140,7524,6865,659,109,508,42,570
Thanet 010,E02005141,6920,5978,942,113,752,77,678
Thanet 011,E02005142,7227,6572,655,70,561,24,587
Thanet 012,E02005143,8143,7145,998,164,793,41,786
Thanet 013,E02005144,8355,7513,842,165,655,22,734
Thanet 014,E02005145,6738,5953,785,158,588,39,517
Thanet 015,E02005146,7789,6661,1128,113,941,74,951
Thanet 016,E02005147,8516,6754,1762,309,1323,130,1188
Thanet 017,E02005148,7564,6908,656,66,561,29,543
Tonbridge and Malling 001,E02005149,10405,9624,781,95,648,38,779
Tonbridge and Malling 002,E02005150,10211,9163,1048,273,746,29,666
Tonbridge and Malling 003,E02005151,12594,11608,986,168,780,38,862
Tonbridge and Malling 005,E02005153,8551,7841,710,104,585,21,548
Tonbridge and Malling 006,E02005154,10943,9925,1018,148,794,76,795
Tonbridge and Malling 007,E02005155,10957,9757,1200,257,876,67,794
Tonbridge and Malling 008,E02005156,7289,6667,622,70,499,53,486
Tonbridge and Malling 009,E02005157,6578,6014,564,65,465,34,488
Tonbridge and Malling 010,E02005158,6567,6038,529,69,422,38,486
Tonbridge and Malling 011,E02005159,7774,7111,663,107,517,39,501
Tonbridge and Malling 012,E02005160,10525,8984,1541,242,1136,163,1030
Tonbridge and Malling 013,E02005161,8204,7212,992,155,767,70,788
Tonbridge and Malling 014,E02006833,10207,9234,973,164,771,38,737
Tunbridge Wells 001,E02005162,10720,9865,855,175,636,44,716
Tunbridge Wells 002,E02005163,8200,7299,901,108,760,33,678
Tunbridge Wells 003,E02005164,7845,7054,791,83,678,30,769
Tunbridge Wells 004,E02005165,7810,7124,686,87,550,49,603
Tunbridge Wells 005,E02005166,7039,6254,785,95,651,39,588
Tunbridge Wells 006,E02005167,7799,7140,659,72,536,51,586
Tunbridge Wells 007,E02005168,7533,6418,1115,76,909,130,964
Tunbridge Wells 008,E02005169,8862,6570,2292,369,1718,205,1332
Tunbridge Wells 009,E02005170,9453,8071,1382,114,1148,120,1060
Tunbridge Wells 010,E02005171,6181,5362,819,86,659,74,628
Tunbridge Wells 011,E02005172,8649,7727,922,122,702,98,730
Tunbridge Wells 012,E02005173,8590,7319,1271,111,1029,131,1013
Tunbridge Wells 013,E02005174,7605,6788,817,135,621,61,599
Tunbridge Wells 014,E02005175,8763,7591,1172,271,817,84,718
Cherwell 001,E02005921,5334,4896,438,64,346,28,449
Cherwell 002,E02005922,8450,7537,913,177,681,55,763
Cherwell 003,E02005923,5868,5266,602,67,467,68,573
Cherwell 004,E02005924,10880,8917,1963,421,1329,213,1262
Cherwell 005,E02005925,8470,7731,739,143,543,53,633
Cherwell 006,E02005926,7776,7027,749,95,597,57,668
Cherwell 007,E02005927,5409,4845,564,50,469,45,491
Cherwell 008,E02005928,7542,6784,758,98,598,62,514
Cherwell 009,E02005929,6852,6232,620,80,484,56,596
Cherwell 010,E02005930,7634,6789,845,131,642,72,554
Cherwell 011,E02005931,9149,8070,1079,106,729,244,891
Cherwell 012,E02005932,7014,6204,810,129,608,73,701
Cherwell 013,E02005933,7427,6787,640,94,497,49,692
Cherwell 014,E02005934,9155,8418,737,139,542,56,631
Cherwell 015,E02005935,7258,6317,941,139,733,69,823
Cherwell 016,E02005936,9276,7896,1380,85,1225,70,757
Cherwell 017,E02005937,6544,5913,631,72,498,61,597
Cherwell 018,E02005938,5598,5107,491,34,394,63,483
Cherwell 019,E02005939,6232,5530,702,77,575,50,543
Oxford 001,E02005940,5866,4937,929,69,709,151,733
Oxford 002,E02005941,7209,5614,1595,138,1145,312,1125
Oxford 003,E02005942,6750,4994,1756,145,1028,583,1283
Oxford 004,E02005943,6259,5245,1014,93,778,143,849
Oxford 005,E02005944,7013,6057,956,89,718,149,739
Oxford 006,E02005945,10495,7095,3400,340,2415,645,2186
Oxford 007,E02005946,7990,6725,1265,150,956,159,1020
Oxford 008,E02005947,16342,8888,7454,512,5101,1841,4683
Oxford 009,E02005948,6820,4549,2271,184,1651,436,1486
Oxford 010,E02005949,7303,4742,2561,239,1906,416,1673
Oxford 011,E02005950,11282,6154,5128,850,3802,476,2862
Oxford 012,E02005951,5944,4376,1568,162,1143,263,1043
Oxford 013,E02005952,14349,10723,3626,445,2699,482,2511
Oxford 014,E02005953,5713,4240,1473,101,1188,184,1232
Oxford 015,E02005954,9640,8094,1546,150,1116,280,1242
Oxford 016,E02005955,9863,8181,1682,256,1274,152,1113
Oxford 017,E02005956,6131,5539,592,79,466,47,487
Oxford 018,E02005957,6937,6198,739,124,563,52,633
South Oxfordshire 001,E02005958,5675,5180,495,103,348,44,449
South Oxfordshire 002,E02005959,5556,4941,615,54,483,78,567
South Oxfordshire 003,E02005960,5886,5332,554,69,431,54,396
South Oxfordshire 004,E02005961,6640,6045,595,107,431,57,477
South Oxfordshire 005,E02005962,8294,7693,601,140,438,23,426
South Oxfordshire 006,E02005963,8166,7397,769,113,589,67,671
South Oxfordshire 007,E02005964,7261,6645,616,127,458,31,477
South Oxfordshire 008,E02005965,5451,4894,557,108,411,38,431
South Oxfordshire 009,E02005966,8043,7135,908,229,623,56,759
South Oxfordshire 010,E02005967,5731,5155,576,68,461,47,473
South Oxfordshire 011,E02005968,7670,6263,1407,150,1170,87,1147
South Oxfordshire 012,E02005969,9141,8247,894,215,622,57,599
South Oxfordshire 013,E02005970,5635,4936,699,95,547,57,598
South Oxfordshire 014,E02005971,5731,5220,511,66,414,31,383
South Oxfordshire 015,E02005972,7982,7298,684,101,542,41,652
South Oxfordshire 016,E02005973,5550,4821,729,140,513,76,538
South Oxfordshire 017,E02005974,6069,5178,891,138,657,96,565
South Oxfordshire 018,E02005975,7910,7136,774,119,577,78,625
South Oxfordshire 019,E02005976,6130,5498,632,61,488,83,509
South Oxfordshire 020,E02005977,5736,5328,408,87,293,28,356
Vale of White Horse 001,E02005978,6670,5939,731,81,590,60,626
Vale of White Horse 002,E02005979,9140,8061,1079,90,848,141,990
Vale of White Horse 003,E02005980,11518,9907,1611,217,1219,175,1175
Vale of White Horse 004,E02005981,8985,8251,734,158,501,75,735
Vale of White Horse 005,E02005982,5849,5258,591,45,483,63,590
Vale of White Horse 006,E02005983,10740,9015,1725,325,1264,136,1230
Vale of White Horse 007,E02005984,6881,6201,680,76,540,64,649
Vale of White Horse 008,E02005985,7556,6731,825,165,600,60,633
Vale of White Horse 009,E02005986,8991,7691,1300,365,874,61,660
Vale of White Horse 010,E02005987,7640,6996,644,87,503,54,636
Vale of White Horse 011,E02005988,7178,6608,570,133,383,54,543
Vale of White Horse 014,E02005991,9803,8513,1290,280,935,75,712
Vale of White Horse 015,E02005992,9014,8073,941,133,746,62,647
Vale of White Horse 016,E02006886,11023,9010,2013,188,1398,427,1533
West Oxfordshire 001,E02005993,6337,5631,706,252,395,59,391
West Oxfordshire 002,E02005994,6078,5393,685,90,526,69,498
West Oxfordshire 003,E02005995,5907,5353,554,112,391,51,453
West Oxfordshire 004,E02005996,8027,7108,919,222,630,67,584
West Oxfordshire 005,E02005997,5555,5070,485,126,327,32,393
West Oxfordshire 006,E02005998,5816,5332,484,52,396,36,416
West Oxfordshire 007,E02005999,6169,5701,468,56,383,29,444
West Oxfordshire 008,E02006000,11829,10541,1288,279,937,72,1041
West Oxfordshire 009,E02006001,5613,5099,514,92,400,22,440
West Oxfordshire 010,E02006002,10080,8789,1291,238,964,89,807
West Oxfordshire 011,E02006003,5416,4889,527,107,387,33,385
West Oxfordshire 012,E02006004,5574,4923,651,87,514,50,484
West Oxfordshire 013,E02006005,9100,7419,1681,353,1243,85,1146
West Oxfordshire 014,E02006006,6669,5671,998,113,835,50,863
West Oxfordshire 015,E02006007,6609,6017,592,85,478,29,462
Elmbridge 001,E02006317,6008,5440,568,70,462,36,452
Elmbridge 002,E02006318,6337,5557,780,111,582,87,637
Elmbridge 003,E02006319,6743,6192,551,70,442,39,518
Elmbridge 004,E02006320,6511,5826,685,71,566,48,598
Elmbridge 005,E02006321,6307,5614,693,49,592,52,565
Elmbridge 006,E02006322,6343,5700,643,57,501,85,619
Elmbridge 007,E02006323,6790,5819,971,85,753,133,733
Elmbridge 008,E02006324,7430,6709,721,77,580,64,613
Elmbridge 009,E02006325,8944,7961,983,52,790,141,598
Elmbridge 010,E02006326,6530,5622,908,85,712,111,677
Elmbridge 011,E02006327,6352,5525,827,80,579,168,649
Elmbridge 012,E02006328,8947,7604,1343,183,974,186,988
Elmbridge 013,E02006329,6743,5971,772,79,528,165,672
Elmbridge 014,E02006330,9290,8342,948,124,690,134,710
Elmbridge 015,E02006331,7168,6471,697,105,521,71,543
Elmbridge 016,E02006332,6502,5570,932,89,627,216,684
Elmbridge 017,E02006333,9489,8156,1333,195,834,304,885
Elmbridge 018,E02006334,8441,7390,1051,86,689,276,764
Epsom and Ewell 001,E02006335,7834,7127,707,56,540,111,578
Epsom and Ewell 002,E02006336,6797,6329,468,43,392,33,512
Epsom and Ewell 003,E02006337,8741,8120,621,48,499,74,571
Epsom and Ewell 004,E02006338,6806,6255,551,23,487,41,503
Epsom and Ewell 005,E02006339,8969,7690,1279,76,1103,100,841
Epsom and Ewell 007,E02006341,9505,8163,1342,132,1113,97,1066
Epsom and Ewell 008,E02006342,7216,5695,1521,177,1188,156,993
Epsom and Ewell 009,E02006343,8686,7842,844,53,688,103,703
Epsom and Ewell 010,E02006837,10548,9566,982,93,815,74,916
Guildford 001,E02006344,8500,7563,937,108,760,69,742
Guildford 002,E02006345,6672,5733,939,72,749,118,916
Guildford 003,E02006346,9829,8960,869,121,642,106,705
Guildford 004,E02006347,7180,6449,731,55,638,38,743
Guildford 005,E02006348,8529,7585,944,63,795,86,712
Guildford 006,E02006349,8161,6661,1500,106,1229,165,1268
Guildford 007,E02006350,6187,5332,855,72,698,85,787
Guildford 008,E02006351,8267,7237,1030,141,773,116,784
Guildford 009,E02006352,6087,4873,1214,101,1004,109,954
Guildford 010,E02006353,6144,5646,498,40,438,20,488
Guildford 011,E02006354,8976,7791,1185,139,922,124,995
Guildford 012,E02006355,7807,5252,2555,231,1907,417,1361
Guildford 013,E02006356,10467,7769,2698,407,1969,322,1915
Guildford 014,E02006357,6156,5671,485,74,372,39,454
Guildford 015,E02006358,8525,5003,3522,428,2369,725,2536
Guildford 016,E02006359,5930,5013,917,69,744,104,782
Guildford 017,E02006360,8268,7413,855,60,713,82,703
Guildford 018,E02006361,5498,4924,574,59,445,70,435
Mole Valley 001,E02006362,6654,6090,564,67,429,68,468
Mole Valley 002,E02006363,5887,5287,600,72,472,56,477
Mole Valley 003,E02006364,7035,6091,944,122,721,101,640
Mole Valley 004,E02006365,5909,5174,735,79,591,65,629
Mole Valley 005,E02006366,7996,7361,635,68,508,59,607
Mole Valley 006,E02006367,5779,5297,482,29,420,33,443
Mole Valley 007,E02006368,5596,5153,443,38,371,34,411
Mole Valley 008,E02006369,6489,5873,616,111,463,42,549
Mole Valley 009,E02006370,6152,5351,801,118,589,94,606
Mole Valley 010,E02006371,7001,6172,829,117,635,77,673
Mole Valley 011,E02006372,6417,5861,556,65,447,44,486
Mole Valley 012,E02006373,7561,6849,712,120,544,48,552
Mole Valley 013,E02006374,6899,6353,546,61,436,49,541
Reigate and Banstead 001,E02006375,6242,5692,550,39,475,36,518
Reigate and Banstead 002,E02006376,9110,7914,1196,106,1050,40,840
Reigate and Banstead 003,E02006377,5804,5377,427,16,363,48,394
Reigate and Banstead 004,E02006378,8823,8115,708,45,629,34,684
Reigate and Banstead 005,E02006379,5830,5275,555,77,436,42,463
Reigate and Banstead 006,E02006380,7123,6494,629,107,472,50,565
Reigate and Banstead 007,E02006381,6891,6196,695,72,578,45,504
Reigate and Banstead 008,E02006382,6528,5964,564,56,479,29,482
Reigate and Banstead 009,E02006383,9433,8082,1351,165,1013,173,938
Reigate and Banstead 010,E02006384,10053,8715,1338,165,1060,113,1023
Reigate and Banstead 011,E02006385,9978,8281,1697,180,1341,176,1046
Reigate and Banstead 012,E02006386,7859,6836,1023,87,855,81,815
Reigate and Banstead 013,E02006387,6427,5833,594,50,487,57,502
Reigate and Banstead 014,E02006388,8857,7832,1025,133,785,107,889
Reigate and Banstead 015,E02006389,6801,6250,551,40,474,37,534
Reigate and Banstead 016,E02006390,7854,7233,621,56,539,26,598
Reigate and Banstead 017,E02006391,5925,5176,749,88,627,34,452
Reigate and Banstead 018,E02006392,8297,7116,1181,212,877,92,785
Runnymede 001,E02006393,6384,4766,1618,226,1219,173,1020
Runnymede 002,E02006394,10607,6534,4073,982,2340,751,1897
Runnymede 003,E02006395,9120,8132,988,127,704,157,737
Runnymede 004,E02006396,5767,5238,529,24,409,96,431
Runnymede 005,E02006397,5940,5066,874,90,490,294,616
Runnymede 006,E02006398,7573,6634,939,124,711,104,631
Runnymede 007,E02006399,10652,9529,1123,102,913,108,860
Runnymede 008,E02006400,5672,5025,647,46,531,70,552
Runnymede 009,E02006401,9208,8254,954,125,734,95,728
Runnymede 010,E02006402,9587,8800,787,93,633,61,627
Spelthorne 001,E02006403,6035,5423,612,45,518,49,492
Spelthorne 002,E02006404,6615,5966,649,101,498,50,624
Spelthorne 003,E02006405,10363,9218,1145,98,969,78,873
Spelthorne 004,E02006406,7861,6650,1211,176,808,227,899
Spelthorne 005,E02006407,8796,8008,788,57,669,62,614
Spelthorne 006,E02006408,8223,7470,753,78,637,38,738
Spelthorne 007,E02006409,6734,6045,689,73,575,41,527
Spelthorne 008,E02006410,8076,7326,750,55,618,77,639
Spelthorne 009,E02006411,7107,6496,611,78,467,66,560
Spelthorne 010,E02006412,6798,6201,597,46,506,45,490
Spelthorne 011,E02006413,6106,5563,543,40,471,32,419
Spelthorne 012,E02006414,6207,5654,553,62,474,17,393
Spelthorne 013,E02006415,6677,5934,743,84,594,65,469
Surrey Heath 001,E02006416,8191,7435,756,58,618,80,643
Surrey Heath 002,E02006417,5592,5019,573,69,449,55,432
Surrey Heath 003,E02006418,6791,6264,527,67,413,47,488
Surrey Heath 004,E02006419,7927,7045,882,105,685,92,764
Surrey Heath 005,E02006420,7411,6587,824,77,656,91,720
Surrey Heath 006,E02006421,8658,7751,907,95,736,76,739
Surrey Heath 007,E02006422,6049,5495,554,53,479,22,450
Surrey Heath 008,E02006423,10349,9049,1300,182,975,143,968
Surrey Heath 009,E02006424,6180,5717,463,16,410,37,520
Surrey Heath 010,E02006425,6178,5649,529,48,434,47,510
Surrey Heath 011,E02006426,5717,5266,451,59,344,48,461
Surrey Heath 012,E02006427,7101,6112,989,59,838,92,728
Tandridge 002,E02006429,7217,6445,772,73,652,47,715
Tandridge 003,E02006430,8976,8186,790,90,666,34,689
Tandridge 004,E02006431,10489,9145,1344,148,1014,182,1023
Tandridge 005,E02006432,5501,5014,487,57,401,29,424
Tandridge 006,E02006433,9417,8519,898,189,650,59,677
Tandridge 007,E02006434,6129,5634,495,104,371,20,379
Tandridge 008,E02006435,5809,5315,494,72,400,22,471
Tandridge 009,E02006436,5949,5498,451,37,392,22,422
Tandridge 010,E02006437,8267,7396,871,195,621,55,584
Tandridge 011,E02006438,7797,7175,622,61,514,47,589
Tandridge 012,E02006790,7447,6892,555,81,435,39,455
Waverley 001,E02006439,5851,5316,535,77,429,29,474
Waverley 002,E02006440,7126,6457,669,64,573,32,590
Waverley 003,E02006441,7617,5992,1625,321,1168,136,956
Waverley 004,E02006442,5927,5311,616,63,484,69,571
Waverley 005,E02006443,7271,6585,686,105,539,42,479
Waverley 006,E02006444,6737,6055,682,43,566,73,554
Waverley 007,E02006445,7233,6053,1180,166,896,118,849
Waverley 008,E02006446,6771,6114,657,75,498,84,574
Waverley 009,E02006447,6230,5503,727,108,547,72,497
Waverley 010,E02006448,7300,6544,756,114,568,74,659
Waverley 011,E02006449,6898,6307,591,77,477,37,488
Waverley 012,E02006450,6979,6256,723,47,564,112,683
Waverley 013,E02006451,10692,9594,1098,255,764,79,668
Waverley 015,E02006453,8025,7218,807,89,563,155,673
Waverley 016,E02006454,6553,5931,622,49,525,48,549
Waverley 017,E02006455,5981,5247,734,85,564,85,526
Waverley 018,E02006839,8381,7499,882,101,675,106,701
Woking 001,E02006456,7724,7053,671,88,542,41,581
Woking 002,E02006457,9124,8101,1023,104,789,130,755
Woking 003,E02006458,9204,8163,1041,110,785,146,847
Woking 004,E02006459,10574,9214,1360,333,767,260,926
Woking 005,E02006460,9488,8550,938,102,762,74,880
Woking 006,E02006461,6735,5822,913,49,728,136,735
Woking 007,E02006462,8452,7528,924,88,771,65,872
Woking 008,E02006463,9534,7656,1878,220,1354,304,1270
Woking 009,E02006464,6866,6208,658,47,553,58,535
Woking 010,E02006465,6188,5393,795,55,619,121,675
Woking 011,E02006466,8768,7944,824,69,696,59,675
Woking 012,E02006467,6541,5945,596,44,504,48,575
Adur 001,E02006534,8524,7879,645,63,560,22,580
Adur 002,E02006535,6634,6180,454,59,373,22,467
Adur 003,E02006536,7100,6503,597,31,492,74,566
Adur 004,E02006537,10127,9057,1070,168,843,59,809
Adur 005,E02006538,8526,7438,1088,180,853,55,780
Adur 006,E02006539,7089,6517,572,53,500,19,520
Adur 007,E02006540,5665,5210,455,42,398,15,469
Adur 008,E02006541,7517,6606,911,112,764,35,585
Arun 001,E02006542,5741,5129,612,130,430,52,435
Arun 002,E02006543,5546,5082,464,58,379,27,394
Arun 003,E02006544,10073,9246,827,158,616,53,654
Arun 004,E02006545,8259,7236,1023,110,862,51,650
Arun 005,E02006546,9631,8699,932,137,753,42,640
Arun 006,E02006547,5926,5076,850,76,721,53,553
Arun 007,E02006548,9452,8527,925,97,791,37,738
Arun 008,E02006549,5870,5317,553,63,471,19,383
Arun 009,E02006550,9414,8661,753,70,650,33,713
Arun 010,E02006551,7785,6926,859,140,685,34,530
Arun 011,E02006552,7109,5820,1289,262,917,110,865
Arun 012,E02006553,7298,6602,696,77,573,46,655
Arun 013,E02006554,6680,6133,547,90,437,20,463
Arun 014,E02006555,7476,6462,1014,109,836,69,860
Arun 015,E02006556,8249,7533,716,156,538,22,505
Arun 016,E02006557,7148,6202,946,102,761,83,819
Arun 017,E02006558,10638,8161,2477,487,1705,285,1414
Arun 018,E02006559,8124,7388,736,102,600,34,569
Arun 019,E02006560,9099,8260,839,166,643,30,502
Chichester 001,E02006561,6740,5978,762,105,597,60,641
Chichester 002,E02006562,5855,5369,486,70,379,37,443
Chichester 003,E02006563,5621,5108,513,62,412,39,493
Chichester 004,E02006564,7238,6512,726,236,449,41,460
Chichester 005,E02006565,8077,7271,806,176,563,67,684
Chichester 006,E02006566,7639,6641,998,100,810,88,607
Chichester 007,E02006567,7446,6771,675,95,547,33,524
Chichester 008,E02006568,10705,8177,2528,543,1836,149,1436
Chichester 009,E02006569,7818,6859,959,100,757,102,922
Chichester 010,E02006570,8374,6645,1729,237,1338,154,1202
Chichester 011,E02006571,7652,6807,845,83,691,71,671
Chichester 012,E02006572,9132,8029,1103,125,905,73,966
Chichester 013,E02006573,10760,9704,1056,296,690,70,629
Chichester 014,E02006574,10737,9643,1094,422,605,67,521
Crawley 001,E02006575,8255,7390,865,138,578,149,773
Crawley 002,E02006576,7958,7196,762,81,632,49,717
Crawley 003,E02006577,7922,7000,922,79,751,92,764
Crawley 004,E02006578,9673,7996,1677,180,1310,187,947
Crawley 005,E02006579,7877,6917,960,97,755,108,711
Crawley 006,E02006580,8007,7222,785,59,669,57,622
Crawley 007,E02006581,8589,7178,1411,155,1104,152,1043
Crawley 008,E02006582,7943,6974,969,172,723,74,610
Crawley 009,E02006583,8945,7917,1028,73,880,75,872
Crawley 010,E02006584,7442,6697,745,82,588,75,697
Crawley 011,E02006585,7770,7052,718,82,576,60,688
Crawley 012,E02006586,7836,7105,731,68,585,78,749
Crawley 013,E02006587,8380,7383,997,132,783,82,790
Horsham 001,E02006588,7481,6627,854,88,701,65,830
Horsham 002,E02006589,11206,10274,932,111,765,56,829
Horsham 003,E02006590,8598,7586,1012,116,794,102,755
Horsham 004,E02006591,7986,7082,904,72,777,55,759
Horsham 005,E02006592,6342,5747,595,62,471,62,541
Horsham 006,E02006593,10460,9056,1404,248,1015,141,1018
Horsham 007,E02006594,6701,6068,633,56,534,43,545
Horsham 008,E02006595,8519,7588,931,85,760,86,706
Horsham 009,E02006596,8692,7976,716,147,526,43,565
Horsham 010,E02006597,9379,8483,896,173,668,55,639
Horsham 011,E02006598,5500,5062,438,67,345,26,414
Horsham 012,E02006599,6984,6365,619,61,502,56,525
Horsham 013,E02006600,9278,8213,1065,201,802,62,670
Horsham 014,E02006601,8133,7322,811,137,586,88,473
Horsham 015,E02006602,7466,6783,683,57,559,67,599
Horsham 016,E02006603,8576,7763,813,199,545,69,691
Mid Sussex 001,E02006604,12480,10888,1592,387,1084,121,831
Mid Sussex 002,E02006605,6527,5803,724,63,578,83,510
Mid Sussex 003,E02006606,8188,7444,744,116,545,83,627
Mid Sussex 004,E02006607,7548,6876,672,90,524,58,563
Mid Sussex 005,E02006608,5770,5400,370,45,305,20,359
Mid Sussex 006,E02006609,7178,6468,710,78,524,108,600
Mid Sussex 007,E02006610,7087,6360,727,84,576,67,591
Mid Sussex 008,E02006611,10153,9089,1064,193,737,134,785
Mid Sussex 009,E02006612,10153,8368,1785,296,1315,174,1138
Mid Sussex 010,E02006613,7218,6529,689,117,531,41,644
Mid Sussex 011,E02006614,10030,8974,1056,99,823,134,934
Mid Sussex 012,E02006615,6773,6184,589,58,497,34,530
Mid Sussex 013,E02006616,8066,7418,648,105,497,46,517
Mid Sussex 014,E02006617,9083,8081,1002,221,660,121,736
Mid Sussex 015,E02006618,6187,5613,574,51,465,58,530
Mid Sussex 016,E02006619,8226,7466,760,101,612,47,628
Mid Sussex 017,E02006620,9193,8301,892,159,698,35,494
Worthing 001,E02006621,7581,6971,610,75,495,40,537
Worthing 002,E02006622,7711,7015,696,37,630,29,651
Worthing 003,E02006623,7887,7088,799,80,685,34,677
Worthing 004,E02006624,7152,6559,593,31,521,41,539
Worthing 005,E02006625,8015,7244,771,73,661,37,650
Worthing 006,E02006626,7409,6682,727,67,620,40,655
Worthing 007,E02006627,8495,7721,774,37,685,52,664
Worthing 008,E02006628,9008,7751,1257,110,1077,70,1073
Worthing 009,E02006629,7930,6971,959,85,828,46,715
Worthing 010,E02006630,8147,6559,1588,153,1301,134,1146
Worthing 011,E02006631,9316,6918,2398,309,1920,169,1466
Worthing 012,E02006632,7999,6928,1071,121,894,56,822
Worthing 013,E02006633,7990,7279,711,94,573,44,546
Bath and North East Somerset 001,E02002985,5213,4727,486,73,386,27,395
Bath and North East Somerset 002,E02002986,5024,4508,516,77,420,19,310
Bath and North East Somerset 003,E02002987,5404,4978,426,52,356,18,355
Bath and North East Somerset 004,E02002988,5469,4886,583,73,452,58,546
Bath and North East Somerset 005,E02002989,5324,4618,706,77,571,58,534
Bath and North East Somerset 006,E02002990,5920,4610,1310,85,1091,134,1075
Bath and North East Somerset 007,E02002991,10259,7361,2898,294,2072,532,1960
Bath and North East Somerset 008,E02002992,5938,5014,924,111,742,71,802
Bath and North East Somerset 009,E02002993,5516,3809,1707,110,1350,247,1332
Bath and North East Somerset 010,E02002994,10199,9161,1038,111,808,119,898
Bath and North East Somerset 011,E02002995,5315,4655,660,125,503,32,540
Bath and North East Somerset 012,E02002996,10633,6000,4633,503,3271,859,3272
Bath and North East Somerset 013,E02002997,6469,3895,2574,329,2100,145,1786
Bath and North East Somerset 014,E02002998,5882,4211,1671,112,1476,83,1210
Bath and North East Somerset 015,E02002999,5529,4927,602,57,501,44,566
Bath and North East Somerset 016,E02003000,9202,8548,654,93,527,34,520
Bath and North East Somerset 017,E02003001,5505,4638,867,78,698,91,641
Bath and North East Somerset 018,E02003002,5419,4671,748,90,586,72,615
Bath and North East Somerset 019,E02003003,5681,4915,766,74,613,79,594
Bath and North East Somerset 020,E02003004,6302,5815,487,64,400,23,394
Bath and North East Somerset 021,E02003005,6154,5613,541,127,382,32,399
Bath and North East Somerset 022,E02003006,8881,7793,1088,126,899,63,916
Bath and North East Somerset 023,E02003007,8307,7519,788,183,569,36,591
Bath and North East Somerset 024,E02003008,5620,5132,488,75,395,18,453
Bath and North East Somerset 025,E02003009,5875,5264,611,73,504,34,495
Bath and North East Somerset 026,E02003010,5854,5287,567,117,430,20,400
Bath and North East Somerset 027,E02003011,5122,4663,459,66,358,35,353
Bournemouth 001,E02003172,6227,5649,578,32,524,22,523
Bournemouth 002,E02003173,6608,5992,616,42,551,23,568
Bournemouth 003,E02003174,8096,7241,855,62,752,41,683
Bournemouth 004,E02003175,8982,8126,856,143,665,48,767
Bournemouth 005,E02003176,7019,6387,632,46,563,23,630
Bournemouth 006,E02003177,7977,7159,818,38,749,31,738
Bournemouth 007,E02003178,8342,7165,1177,86,1042,49,858
Bournemouth 008,E02003179,6469,5852,617,37,552,28,460
Bournemouth 009,E02003180,9481,6383,3098,303,2607,188,1838
Bournemouth 010,E02003181,8496,7042,1454,87,1274,93,1194
Bournemouth 011,E02003182,6561,5699,862,84,697,81,742
Bournemouth 012,E02003183,7069,5399,1670,83,1491,96,1171
Bournemouth 013,E02003184,7911,5432,2479,162,2088,229,1772
Bournemouth 014,E02003185,7524,6720,804,60,700,44,626
Bournemouth 015,E02003186,8799,6815,1984,153,1675,156,1557
Bournemouth 016,E02003187,9110,7367,1743,249,1279,215,1233
Bournemouth 017,E02003188,9950,6326,3624,279,2930,415,2428
Bournemouth 018,E02003189,8372,7052,1320,116,1109,95,999
Bournemouth 019,E02003190,9843,6903,2940,390,2296,254,1620
Bournemouth 020,E02003191,7995,7039,956,98,815,43,743
Bournemouth 021,E02003192,10184,6664,3520,357,2733,430,2383
Bournemouth 023,E02006883,5469,4118,1351,89,1155,107,918
Bournemouth 024,E02006885,7007,5123,1884,197,1506,181,1182
Bristol 001,E02003012,10699,9415,1284,153,1053,78,861
Bristol 002,E02003013,11956,10637,1319,212,983,124,978
Bristol 003,E02003014,7755,6833,922,219,653,50,692
Bristol 004,E02003015,5801,4932,869,44,743,82,618
Bristol 005,E02003016,7529,6002,1527,117,1267,143,1114
Bristol 006,E02003017,6042,5334,708,28,619,61,603
Bristol 007,E02003018,5728,5198,530,40,445,45,504
Bristol 008,E02003019,9339,8289,1050,265,732,53,660
Bristol 009,E02003020,6233,5629,604,50,472,82,535
Bristol 010,E02003021,6771,5174,1597,90,1395,112,1262
Bristol 011,E02003022,5867,5402,465,28,381,56,534
Bristol 012,E02003023,5971,5203,768,42,660,66,822
Bristol 013,E02003024,8759,6968,1791,198,1475,118,1338
Bristol 014,E02003025,6766,6001,765,73,624,68,743
Bristol 015,E02003026,9269,6678,2591,85,2303,203,2423
Bristol 016,E02003027,11911,9185,2726,315,2239,172,1967
Bristol 017,E02003028,8524,6864,1660,114,1417,129,1339
Bristol 018,E02003029,6222,5541,681,54,601,26,564
Bristol 019,E02003030,7176,5954,1222,92,992,138,1042
Bristol 020,E02003031,10253,7394,2859,261,2381,217,2226
Bristol 021,E02003032,7282,6162,1120,76,963,81,802
Bristol 022,E02003033,8999,5067,3932,330,3383,219,2791
Bristol 023,E02003034,12263,9574,2689,438,1999,252,1785
Bristol 025,E02003036,8557,4934,3623,319,2967,337,2264
Bristol 026,E02003037,8734,5124,3610,336,2980,294,2555
Bristol 027,E02003038,6359,5561,798,35,726,37,683
Bristol 028,E02003039,8045,6968,1077,78,927,72,753
Bristol 029,E02003040,9125,7425,1700,211,1334,155,1230
Bristol 030,E02003041,6194,4091,2103,175,1692,236,1615
Bristol 032,E02003043,10938,5019,5919,666,4277,976,3800
Bristol 033,E02003044,5798,5215,583,67,477,39,602
Bristol 034,E02003045,6890,4197,2693,212,2180,301,2135
Bristol 035,E02003046,9214,8086,1128,145,920,63,1017
Bristol 036,E02003047,10037,7896,2141,248,1766,127,1450
Bristol 037,E02003048,6516,5284,1232,95,1015,122,985
Bristol 038,E02003049,7272,6547,725,48,643,34,622
Bristol 039,E02003050,8452,6617,1835,156,1509,170,1414
Bristol 040,E02003051,6664,5480,1184,100,995,89,930
Bristol 041,E02003052,6502,5572,930,88,797,45,727
Bristol 042,E02003053,8066,7195,871,92,717,62,750
Bristol 043,E02003054,6453,5757,696,43,624,29,551
Bristol 044,E02003055,8300,7656,644,85,533,26,640
Bristol 045,E02003056,7216,6656,560,81,465,14,570
Bristol 046,E02003057,5822,5320,502,71,410,21,407
Bristol 047,E02003058,8987,8079,908,95,774,39,728
Bristol 048,E02003059,5638,5076,562,72,462,28,502
Bristol 049,E02003060,10802,9899,903,192,688,23,662
Bristol 050,E02003061,5754,5166,588,117,460,11,429
Bristol 051,E02003062,5836,5246,590,47,534,9,513
Bristol 052,E02003063,7040,6642,398,56,312,30,427
Bristol 053,E02003064,6535,5960,575,107,452,16,493
Bristol 054,E02006887,6634,4378,2256,137,1861,258,1625
Bristol 055,E02006888,6824,5687,1137,107,900,130,919
Bristol 056,E02006889,7347,6263,1084,118,802,164,802
Bristol 057,E02006890,8568,7182,1386,190,1014,182,1171
Cornwall 010,E02003892,6253,5735,518,123,375,20,425
Cornwall 012,E02003893,6481,5949,532,86,424,22,485
Cornwall 013,E02003894,8017,7001,1016,296,693,27,546
Cornwall 016,E02003895,7965,6963,1002,252,706,44,620
Cornwall 017,E02003896,5593,4849,744,137,580,27,515
Cornwall 022,E02003897,5412,4947,465,51,399,15,482
Cornwall 023,E02003898,6606,5957,649,136,484,29,432
Cornwall 025,E02003899,5280,4796,484,97,382,5,382
Cornwall 026,E02003900,7163,6312,851,219,596,36,556
Cornwall 028,E02003901,7453,6754,699,121,554,24,558
Cornwall 029,E02003902,5411,4804,607,220,363,24,416
Cornwall 034,E02003903,6423,5753,670,203,417,50,674
Cornwall 037,E02003904,5325,4714,611,158,421,32,368
Cornwall 032,E02003905,6173,5496,677,139,527,11,622
Cornwall 033,E02003906,5406,4824,582,167,398,17,378
Cornwall 040,E02003907,7565,6635,930,290,601,39,515
Cornwall 042,E02003908,7860,6918,942,133,771,38,907
Cornwall 043,E02003909,9113,7789,1324,238,1038,48,893
Cornwall 044,E02003910,6068,4996,1072,174,852,46,806
Cornwall 047,E02003911,8381,7542,839,123,665,51,671
Cornwall 048,E02003912,7710,6875,835,205,573,57,570
Cornwall 056,E02003913,5804,5077,727,69,615,43,386
Cornwall 060,E02003914,7093,5848,1245,212,966,67,853
Cornwall 062,E02003915,7725,6186,1539,277,1202,60,1223
Cornwall 063,E02003916,6616,4663,1953,347,1499,107,1215
Cornwall 064,E02003917,7456,6613,843,121,684,38,665
Cornwall 045,E02003918,6740,6026,714,101,572,41,547
Cornwall 046,E02003919,6804,6001,803,139,642,22,582
Cornwall 049,E02003920,7214,6328,886,151,699,36,609
Cornwall 050,E02003921,5821,5318,503,96,392,15,473
Cornwall 051,E02003922,7721,6945,776,106,637,33,611
Cornwall 052,E02003923,7204,6337,867,178,675,14,690
Cornwall 053,E02003924,6866,6224,642,91,532,19,553
Cornwall 055,E02003925,7067,6513,554,79,459,16,542
Cornwall 059,E02003926,7764,6985,779,74,663,42,617
Cornwall 066,E02003927,9645,7534,2111,127,1844,140,1349
Cornwall 071,E02003928,11682,10210,1472,524,901,47,844
Cornwall 072,E02003929,6585,5957,628,136,475,17,410
Cornwall 073,E02003930,8917,7734,1183,278,855,50,672
Cornwall 001,E02003931,9934,8726,1208,574,574,60,617
Cornwall 002,E02003932,6945,6198,747,157,531,59,456
Cornwall 003,E02003933,6881,6070,811,238,530,43,508
Cornwall 004,E02003934,6669,5889,780,191,576,13,521
Cornwall 005,E02003935,9216,7750,1466,622,787,57,622
Cornwall 006,E02003936,8257,7316,941,157,737,47,599
Cornwall 007,E02003937,5553,4853,700,165,511,24,407
Cornwall 008,E02003938,6561,5636,925,296,585,44,389
Cornwall 009,E02003939,6721,5982,739,214,495,30,368
Cornwall 011,E02003940,6089,5541,548,69,455,24,459
Cornwall 014,E02003941,7347,6361,986,236,706,44,675
Cornwall 015,E02003942,7389,6476,913,217,661,35,628
Cornwall 054,E02003943,7543,6649,894,279,554,61,481
Cornwall 057,E02003944,9403,8424,979,258,687,34,577
Cornwall 058,E02003945,5973,5258,715,115,554,46,481
Cornwall 061,E02003946,8803,7882,921,136,732,53,617
Cornwall 065,E02003947,6447,5833,614,110,476,28,471
Cornwall 067,E02003948,8265,7344,921,164,714,43,637
Cornwall 068,E02003949,6668,5593,1075,230,807,38,656
Cornwall 069,E02003950,5375,4677,698,146,512,40,338
Cornwall 070,E02003951,6112,5492,620,144,430,46,512
Cornwall 018,E02003952,6671,5710,961,149,763,49,662
Cornwall 019,E02003953,10551,9153,1398,422,917,59,693
Cornwall 020,E02003954,6891,5608,1283,345,871,67,811
Cornwall 021,E02003955,9277,8206,1071,247,778,46,866
Cornwall 024,E02003956,7050,6330,720,174,523,23,521
Cornwall 027,E02003957,10100,8974,1126,194,876,56,788
Cornwall 030,E02003958,7827,6979,848,193,635,20,510
Cornwall 031,E02003959,6873,6199,674,160,498,16,471
Cornwall 035,E02003960,5858,5181,677,170,484,23,422
Cornwall 036,E02003961,9299,8319,980,165,774,41,717
Cornwall 038,E02003962,6344,5579,765,87,644,34,585
Cornwall 039,E02003963,9287,8116,1171,178,953,40,725
Cornwall 041,E02003964,7712,6934,778,177,557,44,465
Isles of Scilly 001,E02006781,2203,1925,278,146,122,10,143
North Somerset 001,E02003065,8503,7385,1118,183,836,99,740
North Somerset 002,E02003066,6014,5553,461,69,366,26,360
North Somerset 003,E02003067,7526,6733,793,136,619,38,598
North Somerset 004,E02003068,6180,5626,554,100,406,48,450
North Somerset 005,E02003069,5409,4743,666,92,546,28,478
North Somerset 006,E02003070,12108,10932,1176,107,988,81,821
North Somerset 007,E02003071,7901,7030,871,193,633,45,724
North Somerset 008,E02003072,9045,8350,695,189,472,34,530
North Somerset 009,E02003073,6585,6197,388,50,312,26,434
North Somerset 010,E02003074,7971,7234,737,172,531,34,551
North Somerset 011,E02003075,5788,5389,399,57,316,26,418
North Somerset 012,E02003076,9273,8538,735,164,536,35,523
North Somerset 013,E02003077,5975,5411,564,122,419,23,422
North Somerset 014,E02003078,6877,6271,606,86,500,20,621
North Somerset 015,E02003079,9599,8783,816,124,664,28,743
North Somerset 016,E02003080,8589,7871,718,78,611,29,701
North Somerset 017,E02003081,9166,8480,686,83,560,43,643
North Somerset 018,E02003082,8583,7083,1500,243,1161,96,983
North Somerset 020,E02003084,9506,7771,1735,379,1223,133,1182
North Somerset 021,E02003085,7534,6590,944,188,721,35,737
North Somerset 022,E02003086,6053,5105,948,158,726,64,645
North Somerset 023,E02003087,9169,8474,695,102,540,53,671
North Somerset 024,E02003088,8361,7510,851,170,593,88,606
North Somerset 025,E02003089,5777,5278,499,49,426,24,422
North Somerset 026,E02006845,7970,6912,1058,119,908,31,671
North Somerset 027,E02006846,7104,5986,1118,205,871,42,864
Plymouth 001,E02003122,6729,6079,650,85,532,33,569
Plymouth 002,E02003123,8033,7156,877,58,784,35,544
Plymouth 003,E02003124,7807,7040,767,88,655,24,712
Plymouth 004,E02003125,5995,5393,602,57,523,22,512
Plymouth 005,E02003126,7262,6334,928,70,766,92,834
Plymouth 006,E02003127,7570,6881,689,55,608,26,630
Plymouth 007,E02003128,8654,7671,983,67,884,32,828
Plymouth 008,E02003129,6521,5762,759,67,638,54,677
Plymouth 009,E02003130,10224,9290,934,165,730,39,803
Plymouth 010,E02003131,7499,6946,553,42,493,18,554
Plymouth 011,E02003132,7935,7146,789,75,667,47,662
Plymouth 012,E02003133,7347,6794,553,41,497,15,551
Plymouth 013,E02003134,6930,6384,546,114,416,16,817
Plymouth 014,E02003135,7479,6516,963,89,852,22,1165
Plymouth 015,E02003136,7905,7292,613,77,527,9,529
Plymouth 016,E02003137,7794,7018,776,102,611,63,685
Plymouth 017,E02003138,7476,6289,1187,136,985,66,971
Plymouth 018,E02003139,6506,5924,582,94,474,14,601
Plymouth 019,E02003140,7697,6995,702,107,570,25,571
Plymouth 020,E02003141,8014,6547,1467,165,1240,62,1153
Plymouth 021,E02003142,9084,8081,1003,116,859,28,969
Plymouth 022,E02003143,7791,7070,721,76,607,38,675
Plymouth 023,E02003144,9041,4626,4415,693,3530,192,2844
Plymouth 024,E02003145,6976,5513,1463,63,1315,85,1122
Plymouth 025,E02003146,9018,5938,3080,359,2567,154,2180
Plymouth 026,E02003147,7645,6370,1275,174,1056,45,824
Plymouth 027,E02003148,9886,5447,4439,637,3582,220,3152
Plymouth 028,E02003149,9340,6544,2796,284,2358,154,2019
Plymouth 029,E02003150,11468,8337,3131,337,2601,193,2059
Plymouth 030,E02003151,7449,6841,608,58,517,33,537
Plymouth 031,E02003152,9426,8621,805,137,623,45,783
Plymouth 032,E02003153,7883,7062,821,84,693,44,645
Poole 001,E02003194,6241,5732,509,52,411,46,493
Poole 002,E02003195,5612,5164,448,33,392,23,510
Poole 003,E02003196,10303,9536,767,130,596,41,671
Poole 004,E02003197,6815,6205,610,66,519,25,559
Poole 005,E02003198,7264,6635,629,65,532,32,626
Poole 006,E02003199,9180,8403,777,104,652,21,719
Poole 007,E02003200,9962,8928,1034,82,911,41,894
Poole 008,E02003201,10573,9359,1214,168,1001,45,1054
Poole 009,E02003202,6206,5009,1197,35,975,187,908
Poole 010,E02003203,7415,6518,897,63,788,46,850
Poole 011,E02003204,8690,7607,1083,105,934,44,810
Poole 012,E02003205,8238,7588,650,79,532,39,610
Poole 013,E02003206,9596,8314,1282,136,1078,68,1050
Poole 014,E02003207,7099,6366,733,132,570,31,792
Poole 015,E02003208,10683,8489,2194,307,1647,240,1432
Poole 016,E02003209,6042,5212,830,115,677,38,550
Poole 017,E02003210,9106,7815,1291,109,1088,94,905
Poole 018,E02003211,8620,7147,1473,119,1236,118,931
South Gloucestershire 001,E02003090,6918,6158,760,112,604,44,448
South Gloucestershire 002,E02003091,6573,6098,475,61,391,23,409
South Gloucestershire 003,E02003092,7915,7030,885,110,725,50,700
South Gloucestershire 004,E02003093,6581,6056,525,89,395,41,381
South Gloucestershire 005,E02003094,8352,7552,800,133,606,61,569
South Gloucestershire 006,E02003095,7123,6591,532,82,418,32,448
South Gloucestershire 007,E02003096,6453,5818,635,77,525,33,500
South Gloucestershire 008,E02003097,6220,5786,434,68,341,25,392
South Gloucestershire 009,E02003098,10038,8516,1522,186,1148,188,1150
South Gloucestershire 010,E02003099,6825,6301,524,77,420,27,489
South Gloucestershire 011,E02003100,10511,9417,1094,239,777,78,710
South Gloucestershire 012,E02003101,10561,9118,1443,197,1087,159,1204
South Gloucestershire 013,E02003102,6520,6080,440,67,364,9,367
South Gloucestershire 014,E02003103,7216,6673,543,96,417,30,507
South Gloucestershire 015,E02003104,7654,7067,587,53,481,53,582
South Gloucestershire 016,E02003105,6298,5850,448,67,337,44,380
South Gloucestershire 017,E02003106,10507,7267,3240,187,2780,273,2321
South Gloucestershire 018,E02003107,10607,8790,1817,249,1328,240,1217
South Gloucestershire 019,E02003108,9307,8374,933,67,830,36,667
South Gloucestershire 020,E02003109,5985,5659,326,31,282,13,351
South Gloucestershire 021,E02003110,10369,9238,1131,179,863,89,968
South Gloucestershire 022,E02003111,6294,5652,642,29,552,61,497
South Gloucestershire 023,E02003112,6381,5879,502,14,460,28,425
South Gloucestershire 024,E02003113,10167,9282,885,119,706,60,741
South Gloucestershire 025,E02003114,6988,6395,593,60,491,42,569
South Gloucestershire 026,E02003115,9159,8184,975,66,869,40,811
South Gloucestershire 027,E02003116,7557,6835,722,90,606,26,549
South Gloucestershire 028,E02003117,8582,7808,774,63,661,50,626
South Gloucestershire 029,E02003118,10199,9371,828,88,710,30,736
South Gloucestershire 030,E02003119,10344,9652,692,101,572,19,670
South Gloucestershire 031,E02003120,8393,7858,535,59,449,27,479
South Gloucestershire 032,E02003121,10170,9500,670,103,550,17,663
Swindon 001,E02003212,8259,7401,858,258,544,56,597
Swindon 003,E02003214,6328,5574,754,170,563,21,571
Swindon 004,E02003215,6993,6456,537,71,445,21,501
Swindon 005,E02003216,9095,8388,707,130,559,18,702
Swindon 006,E02003217,6515,5868,647,62,564,21,490
Swindon 007,E02003218,6575,6000,575,67,491,17,528
Swindon 008,E02003219,6686,6044,642,71,539,32,552
Swindon 009,E02003220,10274,9365,909,112,761,36,784
Swindon 010,E02003221,6450,5522,928,109,734,85,743
Swindon 011,E02003222,6306,5656,650,75,520,55,722
Swindon 012,E02003223,9672,8267,1405,172,1129,104,1077
Swindon 013,E02003224,8742,8100,642,75,532,35,622
Swindon 014,E02003225,5956,5252,704,80,580,44,665
Swindon 015,E02003226,8352,6459,1893,495,1133,265,1147
Swindon 016,E02003227,6339,5647,692,109,529,54,613
Swindon 017,E02003228,6590,5774,816,80,667,69,709
Swindon 018,E02003229,5661,5149,512,60,413,39,573
Swindon 019,E02003230,7273,5385,1888,198,1404,286,1344
Swindon 020,E02003231,8514,7462,1052,190,790,72,728
Swindon 021,E02003232,8145,6783,1362,112,1167,83,924
Swindon 022,E02003233,8859,7869,990,108,833,49,802
Swindon 023,E02003234,8684,7911,773,107,617,49,642
Swindon 024,E02003235,7302,6113,1189,79,1030,80,641
Swindon 025,E02003236,10512,9524,988,192,729,67,756
Swindon 026,E02006847,9257,7878,1379,157,1160,62,983
Swindon 027,E02006848,6789,5368,1421,131,1243,47,876
Swindon 028,E02006849,9028,7950,1078,142,857,79,1011
Torbay 001,E02003154,7178,6504,674,100,551,23,608
Torbay 002,E02003155,5822,5050,772,77,671,24,530
Torbay 003,E02003156,9525,8403,1122,158,915,49,949
Torbay 004,E02003157,6223,5312,911,91,774,46,828
Torbay 005,E02003158,5440,4802,638,78,522,38,615
Torbay 006,E02003159,5747,5009,738,84,630,24,668
Torbay 008,E02003161,6897,5393,1504,254,1152,98,995
Torbay 010,E02003163,7777,6540,1237,173,1005,59,845
Torbay 011,E02003164,8826,7995,831,108,703,20,684
Torbay 012,E02003165,7133,6463,670,69,575,26,656
Torbay 013,E02003166,10477,9436,1041,199,812,30,1051
Torbay 014,E02003167,9018,7430,1588,342,1209,37,933
Torbay 015,E02003168,6910,6285,625,66,544,15,603
Torbay 016,E02003169,6657,6145,512,65,415,32,406
Torbay 017,E02003170,9331,8165,1166,302,813,51,594
Torbay 018,E02003171,7362,6657,705,167,520,18,498
Torbay 019,E02006840,10636,9587,1049,151,851,47,941
Wiltshire 012,E02006634,8635,7712,923,154,687,82,639
Wiltshire 019,E02006635,8395,7272,1123,277,753,93,667
Wiltshire 024,E02006636,6860,6162,698,165,461,72,531
Wiltshire 025,E02006637,10743,9170,1573,334,1168,71,828
Wiltshire 026,E02006638,6262,5540,722,117,557,48,589
Wiltshire 028,E02006639,8494,7729,765,89,633,43,744
Wiltshire 029,E02006640,7069,6507,562,91,437,34,532
Wiltshire 034,E02006641,7416,6591,825,82,657,86,625
Wiltshire 038,E02006642,5768,5068,700,87,566,47,577
Wiltshire 041,E02006643,15048,12278,2770,577,1905,288,1990
Wiltshire 001,E02006644,6744,6169,575,135,403,37,508
Wiltshire 002,E02006645,7157,6301,856,170,593,93,620
Wiltshire 003,E02006646,5601,5115,486,66,383,37,409
Wiltshire 004,E02006647,5897,5349,548,53,447,48,441
Wiltshire 005,E02006648,5855,5167,688,90,544,54,549
Wiltshire 006,E02006649,6864,6073,791,151,609,31,528
Wiltshire 007,E02006650,11290,9793,1497,194,1108,195,1551
Wiltshire 008,E02006651,7234,6550,684,57,583,44,670
Wiltshire 009,E02006652,9541,8544,997,133,795,69,787
Wiltshire 010,E02006653,9829,8957,872,112,719,41,794
Wiltshire 011,E02006654,9353,8083,1270,189,1016,65,844
Wiltshire 013,E02006655,7002,6328,674,78,542,54,552
Wiltshire 014,E02006656,7077,6452,625,109,444,72,649
Wiltshire 015,E02006657,10126,8881,1245,262,900,83,796
Wiltshire 016,E02006658,7148,6494,654,111,492,51,515
Wiltshire 017,E02006659,7648,6583,1065,121,808,136,945
Wiltshire 018,E02006660,13012,11350,1662,412,1074,176,1101
Wiltshire 045,E02006661,9193,6983,2210,378,1623,209,1789
Wiltshire 046,E02006662,5917,5333,584,103,419,62,544
Wiltshire 048,E02006663,10724,9128,1596,336,1141,119,913
Wiltshire 049,E02006664,6526,5894,632,51,524,57,559
Wiltshire 050,E02006665,6560,5958,602,107,463,32,523
Wiltshire 051,E02006666,5645,5132,513,53,443,17,454
Wiltshire 052,E02006667,6369,5698,671,115,544,12,601
Wiltshire 053,E02006668,6104,5565,539,40,473,26,565
Wiltshire 054,E02006669,9710,8543,1167,188,887,92,994
Wiltshire 055,E02006670,6712,5696,1016,158,812,46,946
Wiltshire 056,E02006671,6137,5090,1047,156,806,85,807
Wiltshire 057,E02006672,6652,5814,838,44,734,60,577
Wiltshire 058,E02006673,5003,4371,632,59,498,75,589
Wiltshire 059,E02006674,5712,4729,983,74,818,91,666
Wiltshire 060,E02006675,7909,7207,702,154,512,36,540
Wiltshire 061,E02006676,6119,5401,718,113,526,79,542
Wiltshire 062,E02006677,7792,7107,685,130,502,53,484
Wiltshire 020,E02006678,7344,6645,699,151,521,27,531
Wiltshire 021,E02006679,9744,8698,1046,200,784,62,703
Wiltshire 022,E02006680,7333,6497,836,122,662,52,606
Wiltshire 023,E02006681,5936,5412,524,49,423,52,400
Wiltshire 027,E02006682,9402,8367,1035,230,728,77,624
Wiltshire 030,E02006683,7765,6926,839,101,677,61,750
Wiltshire 031,E02006684,6166,5170,996,137,760,99,622
Wiltshire 032,E02006685,7699,6777,922,96,753,73,778
Wiltshire 033,E02006686,5481,5054,427,38,372,17,422
Wiltshire 035,E02006687,7289,6435,854,87,696,71,764
Wiltshire 036,E02006688,5669,5065,604,66,488,50,560
Wiltshire 037,E02006689,6267,5771,496,34,430,32,548
Wiltshire 039,E02006690,6716,6059,657,63,558,36,548
Wiltshire 040,E02006691,13490,11835,1655,523,1059,73,903
Wiltshire 042,E02006692,5697,4735,962,123,690,149,869
Wiltshire 043,E02006693,5728,5102,626,92,493,41,425
Wiltshire 044,E02006694,6065,5298,767,124,558,85,538
Wiltshire 047,E02006695,6338,5769,569,108,422,39,518
East Devon 001,E02004129,5492,4960,532,93,416,23,370
East Devon 002,E02004130,5919,5129,790,144,601,45,576
East Devon 003,E02004131,5564,4997,567,127,430,10,488
East Devon 004,E02004132,8231,7462,769,110,607,52,644
East Devon 005,E02004133,8180,7217,963,314,615,34,480
East Devon 006,E02004134,6883,6297,586,77,474,35,562
East Devon 007,E02004135,8044,7218,826,179,620,27,544
East Devon 008,E02004136,7959,7130,829,208,586,35,646
East Devon 009,E02004137,5339,4820,519,54,430,35,418
East Devon 010,E02004138,7096,6250,846,302,483,61,484
East Devon 011,E02004139,6372,5738,634,116,500,18,410
East Devon 012,E02004140,5178,4487,691,122,494,75,444
East Devon 013,E02004141,5820,5197,623,72,527,24,572
East Devon 014,E02004142,5981,4855,1126,63,1014,49,726
East Devon 015,E02004143,6320,5801,519,69,433,17,540
East Devon 016,E02004144,6719,5991,728,108,570,50,608
East Devon 017,E02004145,5967,5363,604,150,413,41,458
East Devon 018,E02004146,7223,6598,625,71,531,23,593
East Devon 019,E02004147,7025,5666,1359,384,918,57,752
East Devon 020,E02004148,7145,6171,974,114,815,45,648
Exeter 001,E02004149,9019,5388,3631,160,2744,727,2683
Exeter 002,E02004150,6825,5485,1340,101,1107,132,1094
Exeter 003,E02004151,7957,7204,753,76,625,52,558
Exeter 004,E02004152,8421,4195,4226,751,3075,400,2311
Exeter 005,E02004153,7546,6629,917,168,691,58,713
Exeter 006,E02004154,8173,5756,2417,213,1936,268,1731
Exeter 007,E02004155,7557,6859,698,61,581,56,678
Exeter 008,E02004156,9584,6143,3441,407,2576,458,2313
Exeter 009,E02004157,6587,5075,1512,136,1248,128,1151
Exeter 010,E02004158,7824,6591,1233,159,1002,72,896
Exeter 011,E02004159,9307,8063,1244,186,1013,45,877
Exeter 012,E02004160,7175,6623,552,52,457,43,625
Exeter 013,E02004161,7976,7071,905,68,786,51,837
Exeter 014,E02004162,7231,6193,1038,114,853,71,840
Exeter 015,E02004163,6591,5867,724,126,563,35,530
Mid Devon 001,E02004164,6586,5957,629,110,482,37,511
Mid Devon 002,E02004165,8047,7213,834,185,603,46,671
Mid Devon 003,E02004166,6487,5890,597,97,467,33,477
Mid Devon 004,E02004167,7200,6220,980,214,691,75,743
Mid Devon 005,E02004168,6088,5297,791,192,538,61,571
Mid Devon 006,E02004169,7103,6455,648,149,469,30,537
Mid Devon 007,E02004170,7643,6751,892,264,561,67,587
Mid Devon 008,E02004171,7562,6860,702,132,524,46,519
Mid Devon 009,E02004172,6155,5538,617,123,478,16,532
Mid Devon 010,E02004173,7279,6593,686,127,515,44,584
Mid Devon 011,E02004174,7600,6666,934,325,570,39,474
North Devon 001,E02004175,5517,4661,856,252,573,31,554
North Devon 002,E02004176,5588,5014,574,151,392,31,396
North Devon 003,E02004177,5992,5258,734,209,509,16,488
North Devon 004,E02004178,5471,4924,547,108,407,32,427
North Devon 005,E02004179,9078,7770,1308,343,875,90,757
North Devon 006,E02004180,5900,5311,589,65,494,30,448
North Devon 007,E02004181,5849,5200,649,76,540,33,587
North Devon 008,E02004182,6200,5338,862,139,687,36,670
North Devon 009,E02004183,5782,5101,681,93,535,53,531
North Devon 010,E02004184,8614,7614,1000,234,725,41,832
North Devon 011,E02004185,5811,5140,671,110,542,19,360
North Devon 012,E02004186,8224,7364,860,131,696,33,693
North Devon 013,E02004187,9336,8299,1037,357,624,56,646
North Devon 014,E02004188,6305,5793,512,83,403,26,450
South Hams 001,E02004189,5925,5344,581,48,499,34,581
South Hams 002,E02004190,7883,7058,825,119,647,59,661
South Hams 003,E02004191,8076,6930,1146,378,692,76,750
South Hams 004,E02004192,7163,6469,694,65,589,40,523
South Hams 005,E02004193,11851,10787,1064,394,638,32,754
South Hams 006,E02004194,6235,5498,737,116,563,58,690
South Hams 007,E02004195,5605,4712,893,243,597,53,463
South Hams 008,E02004196,7120,6372,748,171,541,36,573
South Hams 009,E02004197,6269,5717,552,89,427,36,456
South Hams 010,E02004198,6423,5642,781,241,503,37,459
South Hams 011,E02004199,5351,4785,566,95,436,35,384
South Hams 012,E02004200,5239,4561,678,146,473,59,361
Teignbridge 001,E02004201,5193,4722,471,37,399,35,445
Teignbridge 002,E02004202,7759,6997,762,159,567,36,617
Teignbridge 003,E02004203,5636,5090,546,135,371,40,400
Teignbridge 004,E02004204,9304,8353,951,263,621,67,703
Teignbridge 005,E02004205,6450,5860,590,117,446,27,522
Teignbridge 006,E02004206,6711,5889,822,224,569,29,504
Teignbridge 007,E02004207,5957,5408,549,84,437,28,446
Teignbridge 008,E02004208,7969,7091,878,134,668,76,646
Teignbridge 009,E02004209,8306,7574,732,147,557,28,586
Teignbridge 010,E02004210,6780,5827,953,256,660,37,595
Teignbridge 011,E02004211,6499,5781,718,101,566,51,472
Teignbridge 012,E02004212,5939,5254,685,76,578,31,537
Teignbridge 013,E02004213,5668,4739,929,53,832,44,687
Teignbridge 014,E02004214,5919,5050,869,155,681,33,698
Teignbridge 015,E02004215,5650,5019,631,88,522,21,577
Teignbridge 016,E02004216,5562,5099,463,51,406,6,430
Teignbridge 017,E02004217,7718,6951,767,217,514,36,597
Teignbridge 018,E02004218,5679,5130,549,54,477,18,421
Teignbridge 019,E02004219,5521,5023,498,79,401,18,394
Torridge 001,E02004220,6184,5507,677,127,526,24,555
Torridge 002,E02004221,5878,5166,712,105,570,37,452
Torridge 003,E02004222,5717,4770,947,206,689,52,622
Torridge 004,E02004223,11348,9906,1442,389,1002,51,831
Torridge 005,E02004224,6254,5583,671,187,447,37,533
Torridge 006,E02004225,5714,5018,696,240,438,18,334
Torridge 007,E02004226,6916,6241,675,115,523,37,538
Torridge 008,E02004227,8929,8087,842,216,587,39,519
Torridge 009,E02004228,6899,6347,552,96,428,28,429
West Devon 001,E02004229,7963,7075,888,181,663,44,475
West Devon 002,E02004230,7500,6459,1041,386,585,70,495
West Devon 003,E02004231,6793,5878,915,170,684,61,741
West Devon 004,E02004232,6529,5940,589,90,474,25,461
West Devon 005,E02004233,12280,10739,1541,472,988,81,779
West Devon 006,E02004234,6119,5580,539,105,404,30,443
West Devon 007,E02004235,6369,5722,647,137,472,38,438
Christchurch 001,E02004236,5773,5270,503,44,417,42,472
Christchurch 002,E02004237,7783,7121,662,56,576,30,500
Christchurch 003,E02004238,7094,6361,733,106,571,56,494
Christchurch 004,E02004239,5587,5078,509,67,419,23,362
Christchurch 005,E02004240,6077,5547,530,95,414,21,472
Christchurch 006,E02004241,9010,7855,1155,151,935,69,870
Christchurch 007,E02004242,6428,5755,673,91,547,35,442
East Dorset 001,E02004243,6465,5989,476,58,392,26,482
East Dorset 002,E02004244,7221,6591,630,104,496,30,576
East Dorset 003,E02004245,7631,6947,684,94,537,53,554
East Dorset 004,E02004246,6859,6312,547,45,439,63,488
East Dorset 005,E02004247,5931,5419,512,68,419,25,454
East Dorset 006,E02004248,7561,6809,752,97,617,38,495
East Dorset 007,E02004249,5393,4996,397,61,307,29,382
East Dorset 008,E02004250,7643,6811,832,104,670,58,564
East Dorset 009,E02004251,6334,5832,502,33,437,32,483
East Dorset 010,E02004252,7014,6174,840,152,649,39,600
East Dorset 011,E02004253,8981,8104,877,100,726,51,721
East Dorset 012,E02004254,10133,9251,882,153,691,38,740
North Dorset 001,E02004255,7502,6644,858,213,589,56,560
North Dorset 002,E02004256,9204,8210,994,153,773,68,802
North Dorset 003,E02004257,7314,6202,1112,336,711,65,472
North Dorset 004,E02004258,10329,9150,1179,382,723,74,650
North Dorset 005,E02004259,7095,6129,966,102,785,79,743
North Dorset 006,E02004260,9442,7530,1912,114,1577,221,1430
North Dorset 007,E02004261,9983,8675,1308,490,773,45,717
North Dorset 008,E02004262,7714,7051,663,97,525,41,588
Purbeck 001,E02004263,5692,5154,538,73,445,20,440
Purbeck 002,E02004264,7983,7274,709,89,591,29,535
Purbeck 003,E02004265,8270,7547,723,266,424,33,452
Purbeck 004,E02004266,8392,7209,1183,227,823,133,840
Purbeck 005,E02004267,5035,4547,488,84,377,27,428
Purbeck 006,E02004268,9601,8544,1057,433,583,41,504
West Dorset 001,E02004269,9523,8114,1409,321,889,199,793
West Dorset 002,E02004270,7489,6882,607,72,479,56,612
West Dorset 003,E02004271,9772,8695,1077,244,745,88,734
West Dorset 004,E02004272,11403,10227,1176,218,869,89,954
West Dorset 005,E02004273,7085,6301,784,209,530,45,477
West Dorset 006,E02004274,6460,5762,698,127,546,25,437
West Dorset 007,E02004275,7419,6647,772,130,591,51,616
West Dorset 008,E02004276,5675,5002,673,141,501,31,519
West Dorset 009,E02004277,10290,8567,1723,382,1264,77,958
West Dorset 010,E02004278,8770,7908,862,190,643,29,628
West Dorset 011,E02004279,7769,7016,753,109,609,35,572
West Dorset 012,E02004280,7609,6982,627,116,486,25,576
Weymouth and Portland 001,E02004281,7316,6559,757,153,571,33,580
Weymouth and Portland 002,E02004282,8641,7850,791,141,620,30,577
Weymouth and Portland 003,E02004283,8669,7898,771,124,601,46,714
Weymouth and Portland 004,E02004284,9470,7541,1929,460,1366,103,1135
Weymouth and Portland 005,E02004285,7465,6567,898,126,733,39,720
Weymouth and Portland 006,E02004286,5191,4728,463,39,405,19,429
Weymouth and Portland 007,E02004287,5571,5065,506,75,423,8,397
Weymouth and Portland 008,E02004288,5643,4655,988,137,789,62,705
Weymouth and Portland 009,E02004289,7201,6569,632,200,402,30,502
Cheltenham 001,E02004600,5700,5028,672,86,545,41,546
Cheltenham 002,E02004601,5165,4703,462,27,394,41,428
Cheltenham 003,E02004602,6432,5708,724,78,602,44,655
Cheltenham 004,E02004603,7675,4777,2898,646,2067,185,1577
Cheltenham 005,E02004604,7955,6890,1065,183,830,52,860
Cheltenham 006,E02004605,5731,5107,624,90,491,43,495
Cheltenham 007,E02004606,9788,7939,1849,177,1540,132,1453
Cheltenham 008,E02004607,9449,7115,2334,280,1854,200,1708
Cheltenham 009,E02004608,10461,7305,3156,370,2412,374,2019
Cheltenham 010,E02004609,7276,6423,853,87,682,84,805
Cheltenham 011,E02004610,8036,6449,1587,142,1273,172,1191
Cheltenham 012,E02004611,11088,9728,1360,194,1090,76,907
Cheltenham 013,E02004612,9437,8562,875,140,673,62,707
Cheltenham 014,E02004613,6264,5532,732,42,611,79,666
Cheltenham 015,E02004614,5275,4737,538,58,417,63,411
Cotswold 001,E02004615,7929,7098,831,193,566,72,549
Cotswold 002,E02004616,8652,7598,1054,265,729,60,668
Cotswold 003,E02004617,7679,6858,821,158,571,92,599
Cotswold 004,E02004618,7297,6443,854,113,624,117,722
Cotswold 005,E02004619,7293,6443,850,108,672,70,752
Cotswold 006,E02004620,7686,6825,861,175,666,20,656
Cotswold 007,E02004621,6305,4903,1402,225,1092,85,777
Cotswold 008,E02004622,6871,5887,984,120,812,52,728
Cotswold 009,E02004623,8004,7217,787,209,525,53,532
Cotswold 010,E02004624,5876,5200,676,106,523,47,548
Cotswold 011,E02004625,9289,8275,1014,268,658,88,693
Forest of Dean 001,E02004626,9677,8332,1345,113,1136,96,876
Forest of Dean 002,E02004627,5350,4755,595,175,389,31,337
Forest of Dean 003,E02004628,7759,7233,526,132,359,35,502
Forest of Dean 004,E02004629,12262,11092,1170,494,646,30,536
Forest of Dean 005,E02004630,6556,5995,561,114,390,57,423
Forest of Dean 006,E02004631,5009,4587,422,46,338,38,381
Forest of Dean 007,E02004632,10011,9141,870,381,455,34,523
Forest of Dean 008,E02004633,8168,7557,611,155,436,20,475
Forest of Dean 009,E02004634,9993,9117,876,309,529,38,590
Forest of Dean 010,E02004635,7176,6409,767,161,532,74,623
Gloucester 001,E02004636,8081,7243,838,121,691,26,715
Gloucester 002,E02004637,8862,7071,1791,262,1376,153,1186
Gloucester 003,E02004638,5776,5235,541,48,469,24,428
Gloucester 004,E02004639,8219,5922,2297,263,1877,157,1469
Gloucester 005,E02004640,7846,6771,1075,241,723,111,819
Gloucester 006,E02004641,7273,6683,590,73,494,23,514
Gloucester 007,E02004642,11875,10766,1109,130,929,50,947
Gloucester 008,E02004643,7817,6846,971,103,793,75,797
Gloucester 009,E02004644,8702,7735,967,103,829,35,805
Gloucester 010,E02004645,9490,8665,825,142,645,38,773
Gloucester 011,E02004646,8500,7658,842,120,698,24,712
Gloucester 012,E02004647,5889,5368,521,33,470,18,449
Gloucester 013,E02004648,5839,5336,503,53,424,26,447
Gloucester 014,E02004649,7098,6330,768,115,626,27,722
Gloucester 015,E02004650,10421,8586,1835,195,1384,256,915
Stroud 001,E02004651,7628,6787,841,81,732,28,733
Stroud 002,E02004652,6300,5717,583,96,445,42,550
Stroud 003,E02004653,6554,5979,575,124,409,42,429
Stroud 004,E02004654,11229,10063,1166,227,888,51,848
Stroud 005,E02004655,7725,6985,740,158,547,35,545
Stroud 006,E02004656,11093,9548,1545,395,1079,71,997
Stroud 007,E02004657,6870,6196,674,77,563,34,683
Stroud 008,E02004658,6509,5959,550,126,399,25,464
Stroud 009,E02004659,6259,5805,454,40,367,47,432
Stroud 010,E02004660,6473,5818,655,80,531,44,511
Stroud 011,E02004661,8162,7383,779,210,539,30,518
Stroud 012,E02004662,6060,5431,629,175,423,31,471
Stroud 013,E02004663,6614,5896,718,155,516,47,532
Stroud 014,E02004664,6697,5979,718,177,524,17,446
Stroud 015,E02004665,8606,7836,770,184,526,60,487
Tewkesbury 001,E02004666,11583,10186,1397,407,848,142,869
Tewkesbury 002,E02004667,10295,8993,1302,348,861,93,670
Tewkesbury 003,E02004668,8250,7370,880,244,553,83,574
Tewkesbury 004,E02004669,6603,6021,582,35,487,60,555
Tewkesbury 005,E02004670,12693,11535,1158,333,759,66,898
Tewkesbury 006,E02004671,5863,5354,509,38,427,44,493
Tewkesbury 007,E02004672,12520,10632,1888,309,1003,576,907
Tewkesbury 008,E02004673,5417,4831,586,33,450,103,386
Tewkesbury 009,E02004674,8719,7710,1009,161,787,61,605
Mendip 001,E02006047,8183,7392,791,146,602,43,755
Mendip 002,E02006048,6971,6324,647,116,481,50,482
Mendip 003,E02006049,7418,6746,672,155,492,25,592
Mendip 004,E02006050,8265,7144,1121,192,870,59,730
Mendip 005,E02006051,7665,6860,805,105,628,72,598
Mendip 006,E02006052,7792,7028,764,82,604,78,712
Mendip 007,E02006053,9187,8143,1044,212,780,52,838
Mendip 008,E02006054,7666,6725,941,274,603,64,698
Mendip 009,E02006055,8781,7660,1121,320,741,60,624
Mendip 010,E02006056,7358,6597,761,128,565,68,548
Mendip 011,E02006057,7434,6499,935,193,664,78,660
Mendip 012,E02006058,8456,7279,1177,169,869,139,713
Mendip 013,E02006059,6479,5794,685,78,536,71,577
Mendip 014,E02006060,7624,6714,910,268,588,54,559
Sedgemoor 001,E02006061,8899,8069,830,283,498,49,509
Sedgemoor 002,E02006062,10644,9453,1191,207,933,51,785
Sedgemoor 003,E02006063,7000,6494,506,83,373,50,469
Sedgemoor 004,E02006064,7807,6798,1009,213,737,59,658
Sedgemoor 005,E02006065,8463,7452,1011,219,759,33,712
Sedgemoor 006,E02006066,7681,7075,606,118,468,20,569
Sedgemoor 007,E02006067,6991,6329,662,132,491,39,483
Sedgemoor 008,E02006068,7579,6672,907,146,725,36,700
Sedgemoor 009,E02006069,9745,8165,1580,398,1079,103,1124
Sedgemoor 010,E02006070,6772,6057,715,143,533,39,610
Sedgemoor 011,E02006071,8473,7534,939,178,726,35,629
Sedgemoor 012,E02006072,9147,8458,689,126,535,28,551
Sedgemoor 013,E02006073,7029,6134,895,148,717,30,761
Sedgemoor 014,E02006074,8358,7190,1168,145,958,65,580
South Somerset 001,E02006075,5349,4624,725,109,539,77,484
South Somerset 002,E02006076,8507,7653,854,143,667,44,597
South Somerset 003,E02006077,5402,4869,533,147,360,26,346
South Somerset 004,E02006078,5702,5106,596,142,415,39,414
South Somerset 005,E02006079,7057,6166,891,298,537,56,496
South Somerset 006,E02006080,7061,5949,1112,131,899,82,847
South Somerset 007,E02006081,5299,4855,444,68,359,17,390
South Somerset 008,E02006082,6467,5699,768,172,548,48,437
South Somerset 009,E02006083,5724,5174,550,120,392,38,389
South Somerset 010,E02006084,7077,6484,593,122,444,27,548
South Somerset 011,E02006085,5875,5264,611,89,503,19,517
South Somerset 012,E02006086,6917,6130,787,103,638,46,715
South Somerset 013,E02006087,6137,5332,805,94,669,42,660
South Somerset 014,E02006088,7357,6303,1054,266,726,62,709
South Somerset 015,E02006089,6392,5288,1104,155,827,122,859
South Somerset 016,E02006090,7021,6239,782,71,650,61,736
South Somerset 017,E02006091,9775,8978,797,171,583,43,767
South Somerset 018,E02006092,6182,5519,663,75,552,36,507
South Somerset 019,E02006093,8445,7546,899,267,585,47,557
South Somerset 020,E02006094,5310,4891,419,38,358,23,376
South Somerset 021,E02006095,7826,6971,855,290,535,30,433
South Somerset 022,E02006096,6704,6029,675,148,485,42,558
South Somerset 023,E02006097,6370,5518,852,249,552,51,500
South Somerset 024,E02006098,7287,6750,537,78,417,42,557
Taunton Deane 001,E02006099,6829,6064,765,173,533,59,554
Taunton Deane 002,E02006100,7468,6496,972,78,741,153,806
Taunton Deane 003,E02006101,5602,4984,618,142,443,33,355
Taunton Deane 004,E02006102,7141,6549,592,88,471,33,569
Taunton Deane 005,E02006103,7234,6611,623,106,476,41,461
Taunton Deane 006,E02006104,7544,6792,752,116,613,23,665
Taunton Deane 007,E02006105,10305,8281,2024,350,1513,161,1438
Taunton Deane 008,E02006106,7704,6716,988,120,835,33,711
Taunton Deane 009,E02006107,8164,7320,844,119,686,39,820
Taunton Deane 010,E02006108,8561,6985,1576,181,1254,141,1061
Taunton Deane 011,E02006109,7855,7000,855,128,691,36,714
Taunton Deane 012,E02006110,7892,6791,1101,271,780,50,602
Taunton Deane 013,E02006111,10451,9283,1168,232,876,60,741
Taunton Deane 014,E02006112,7437,6711,726,92,585,49,678
West Somerset 001,E02006113,7327,6286,1041,385,632,24,537
West Somerset 002,E02006114,6728,5864,864,154,614,96,613
West Somerset 003,E02006115,7218,6554,664,197,444,23,524
West Somerset 004,E02006116,7856,7060,796,143,610,43,573
West Somerset 005,E02006117,5546,4989,557,136,398,23,399
Isle of Anglesey 001,W02000001,8632,7786,846,349,477,20,391
Isle of Anglesey 002,W02000002,6512,5998,514,89,401,24,419
Isle of Anglesey 003,W02000003,10277,9080,1197,687,473,37,411
Isle of Anglesey 004,W02000004,7391,6821,570,135,401,34,400
Isle of Anglesey 005,W02000005,8803,8031,772,214,519,39,576
Isle of Anglesey 006,W02000006,6650,6158,492,163,316,13,354
Isle of Anglesey 007,W02000007,7206,6315,891,198,642,51,632
Isle of Anglesey 008,W02000008,6483,5779,704,117,511,76,495
Isle of Anglesey 009,W02000009,7797,7130,667,180,465,22,462
Gwynedd 001,W02000010,9810,4642,5168,1972,2576,620,1851
Gwynedd 002,W02000011,7765,6562,1203,179,890,134,885
Gwynedd 003,W02000012,8351,7563,788,257,501,30,553
Gwynedd 004,W02000013,6590,5786,804,179,568,57,482
Gwynedd 005,W02000014,6936,6294,642,157,457,28,490
Gwynedd 006,W02000015,8083,7340,743,302,402,39,515
Gwynedd 007,W02000016,6364,5774,590,165,409,16,412
Gwynedd 008,W02000017,7671,6979,692,287,391,14,395
Gwynedd 009,W02000018,6479,5866,613,285,309,19,275
Gwynedd 010,W02000019,7037,6262,775,247,497,31,378
Gwynedd 011,W02000020,6870,6232,638,195,404,39,372
Gwynedd 012,W02000021,7953,7021,932,428,480,24,415
Gwynedd 013,W02000022,6168,5494,674,262,389,23,346
Gwynedd 014,W02000023,5922,5233,689,148,521,20,209
Gwynedd 015,W02000024,5707,5134,573,210,343,20,320
Gwynedd 016,W02000025,6654,5817,837,395,411,31,338
Gwynedd 017,W02000026,7514,6560,954,411,517,26,416
Conwy 001,W02000027,8850,7375,1475,363,1033,79,903
Conwy 002,W02000028,6968,6339,629,63,537,29,503
Conwy 003,W02000029,6358,5684,674,92,537,45,473
Conwy 004,W02000030,6118,5342,776,111,630,35,508
Conwy 005,W02000031,8460,7707,753,123,610,20,500
Conwy 006,W02000032,7815,7002,813,105,668,40,517
Conwy 007,W02000033,6698,5673,1025,259,729,37,642
Conwy 008,W02000034,7830,7001,829,88,637,104,631
Conwy 009,W02000035,8851,8036,815,207,579,29,604
Conwy 010,W02000036,10577,9591,986,290,665,31,630
Conwy 011,W02000037,6962,6262,700,102,572,26,429
Conwy 012,W02000038,6072,5470,602,146,427,29,464
Conwy 013,W02000039,7990,7108,882,298,556,28,489
Conwy 014,W02000040,6881,6327,554,142,387,25,418
Conwy 015,W02000041,8798,7895,903,395,479,29,465
Denbighshire 001,W02000042,5716,5114,602,112,476,14,458
Denbighshire 002,W02000043,5358,4816,542,76,431,35,360
Denbighshire 003,W02000044,5197,4777,420,54,359,7,346
Denbighshire 004,W02000045,8603,7317,1286,394,843,49,1020
Denbighshire 006,W02000047,5383,4816,567,94,457,16,490
Denbighshire 008,W02000049,6496,5947,549,126,400,23,437
Denbighshire 009,W02000050,6402,5764,638,100,510,28,576
Denbighshire 010,W02000051,5325,4837,488,72,402,14,368
Denbighshire 011,W02000052,5287,4683,604,172,378,54,345
Denbighshire 012,W02000053,6417,5932,485,120,353,12,410
Denbighshire 013,W02000054,6033,5501,532,61,457,14,453
Denbighshire 014,W02000055,5461,4824,637,213,345,79,325
Denbighshire 015,W02000056,5227,4799,428,120,293,15,292
Denbighshire 016,W02000057,6212,5664,548,198,329,21,338
Denbighshire 017,W02000419,10617,9763,854,158,671,25,739
Flintshire 001,W02000058,5173,4763,410,90,311,9,430
Flintshire 002,W02000059,6565,6025,540,144,379,17,457
Flintshire 003,W02000060,10652,9769,883,334,523,26,549
Flintshire 004,W02000061,6584,5896,688,242,418,28,404
Flintshire 005,W02000062,6369,5909,460,107,334,19,425
Flintshire 006,W02000063,8381,7803,578,135,408,35,438
Flintshire 007,W02000064,6104,5497,607,179,411,17,500
Flintshire 008,W02000065,7501,6925,576,110,428,38,579
Flintshire 009,W02000066,9659,8634,1025,219,747,59,669
Flintshire 010,W02000067,6330,5943,387,49,320,18,409
Flintshire 011,W02000068,5605,4999,606,97,479,30,453
Flintshire 012,W02000069,6062,5551,511,70,416,25,411
Flintshire 013,W02000070,10560,9762,798,181,582,35,629
Flintshire 014,W02000071,7386,6926,460,67,362,31,364
Flintshire 015,W02000072,11106,10016,1090,287,770,33,656
Flintshire 016,W02000073,10058,9299,759,209,521,29,573
Flintshire 017,W02000074,9336,8497,839,280,535,24,612
Flintshire 018,W02000075,5571,5185,386,54,311,21,354
Flintshire 019,W02000076,7430,6936,494,92,383,19,474
Flintshire 020,W02000077,6074,5559,515,134,370,11,386
Wrexham 003,W02000080,7918,7409,509,102,398,9,421
Wrexham 004,W02000081,5904,5346,558,86,461,11,375
Wrexham 005,W02000082,7454,6717,737,177,535,25,552
Wrexham 006,W02000083,8683,7851,832,224,587,21,575
Wrexham 007,W02000084,5109,4811,298,35,251,12,288
Wrexham 008,W02000085,9162,8002,1160,198,843,119,781
Wrexham 009,W02000086,5115,4622,493,49,430,14,372
Wrexham 010,W02000087,7401,6692,709,222,460,27,466
Wrexham 011,W02000088,8296,6658,1638,350,1087,201,962
Wrexham 012,W02000089,8372,7164,1208,265,820,123,898
Wrexham 013,W02000090,5861,5463,398,66,325,7,309
Wrexham 014,W02000091,6163,5666,497,91,392,14,450
Wrexham 015,W02000092,7046,6372,674,201,460,13,436
Wrexham 016,W02000093,6645,5989,656,113,513,30,492
Wrexham 017,W02000094,9110,8303,807,352,440,15,420
Wrexham 018,W02000095,6494,5937,557,96,425,36,369
Wrexham 019,W02000096,6647,6157,490,154,324,12,356
Wrexham 020,W02000420,13464,12475,989,240,703,46,905
Powys 001,W02000097,9114,8329,785,267,482,36,505
Powys 002,W02000098,6299,5768,531,101,390,40,349
Powys 003,W02000099,6664,5933,731,312,359,60,404
Powys 004,W02000100,6206,5624,582,238,329,15,306
Powys 005,W02000101,5485,5021,464,90,361,13,397
Powys 006,W02000102,6306,5816,490,100,370,20,395
Powys 007,W02000103,5720,5340,380,96,266,18,381
Powys 008,W02000104,6180,5416,764,244,483,37,458
Powys 009,W02000105,5177,4684,493,152,330,11,354
Powys 010,W02000106,6628,6046,582,279,279,24,308
Powys 011,W02000107,9945,9048,897,344,498,55,511
Powys 012,W02000108,7062,6465,597,203,372,22,415
Powys 013,W02000109,5309,4617,692,318,341,33,353
Powys 014,W02000110,7035,6358,677,283,355,39,356
Powys 015,W02000111,8430,7593,837,291,495,51,454
Powys 017,W02000113,8250,7102,1148,343,638,167,579
Powys 018,W02000114,6942,6233,709,139,475,95,486
Powys 020,W02000414,6014,5555,459,106,338,15,394
Powys 021,W02000416,10210,9426,784,364,395,25,449
Ceredigion 001,W02000116,7660,6862,798,221,541,36,579
Ceredigion 002,W02000117,9998,4405,5593,2021,3101,471,1904
Ceredigion 003,W02000118,7761,5408,2353,269,1874,210,1432
Ceredigion 005,W02000120,7344,6590,754,273,445,36,463
Ceredigion 007,W02000122,6722,6057,665,171,474,20,377
Ceredigion 008,W02000123,8345,7121,1224,348,798,78,619
Ceredigion 009,W02000124,8866,7883,983,441,505,37,407
Ceredigion 010,W02000125,7504,6828,676,174,464,38,438
Ceredigion 011,W02000421,11722,10660,1062,290,709,63,823
Pembrokeshire 001,W02000126,8190,7498,692,188,483,21,448
Pembrokeshire 002,W02000127,9751,8784,967,404,513,50,405
Pembrokeshire 003,W02000128,7534,6689,845,265,532,48,477
Pembrokeshire 004,W02000129,6741,6165,576,113,440,23,402
Pembrokeshire 005,W02000130,6952,5815,1137,219,825,93,800
Pembrokeshire 006,W02000131,6958,6230,728,144,526,58,651
Pembrokeshire 007,W02000132,6438,5804,634,171,428,35,433
Pembrokeshire 008,W02000133,8023,7203,820,174,611,35,583
Pembrokeshire 009,W02000134,8531,7683,848,264,536,48,612
Pembrokeshire 010,W02000135,6923,6071,852,231,587,34,489
Pembrokeshire 011,W02000136,8540,7683,857,246,560,51,521
Pembrokeshire 012,W02000137,6984,6168,816,330,459,27,494
Pembrokeshire 013,W02000138,9753,8550,1203,515,636,52,569
Pembrokeshire 014,W02000139,7694,6972,722,170,501,51,485
Pembrokeshire 015,W02000140,7021,6322,699,191,478,30,532
Pembrokeshire 016,W02000141,6406,5644,762,291,419,52,425
Carmarthenshire 001,W02000142,5658,5110,548,151,373,24,353
Carmarthenshire 002,W02000143,5820,5300,520,139,326,55,359
Carmarthenshire 003,W02000144,7713,7107,606,131,447,28,445
Carmarthenshire 004,W02000145,7148,6563,585,164,385,36,410
Carmarthenshire 005,W02000146,6606,6087,519,63,433,23,440
Carmarthenshire 006,W02000147,8261,7039,1222,230,935,57,773
Carmarthenshire 007,W02000148,5142,4532,610,94,479,37,491
Carmarthenshire 008,W02000149,6181,5337,844,145,643,56,618
Carmarthenshire 010,W02000151,7407,6783,624,240,371,13,369
Carmarthenshire 011,W02000152,8105,7296,809,160,623,26,461
Carmarthenshire 012,W02000153,7739,7077,662,129,510,23,468
Carmarthenshire 013,W02000154,7586,6832,754,226,506,22,545
Carmarthenshire 015,W02000156,8159,7455,704,158,519,27,455
Carmarthenshire 016,W02000157,8989,8256,733,167,529,37,515
Carmarthenshire 017,W02000158,5664,5268,396,76,308,12,389
Carmarthenshire 018,W02000159,6064,5492,572,171,387,14,323
Carmarthenshire 019,W02000160,7500,6966,534,78,414,42,461
Carmarthenshire 020,W02000161,5651,5119,532,91,424,17,460
Carmarthenshire 021,W02000162,8547,7825,722,263,422,37,424
Carmarthenshire 022,W02000163,5457,4889,568,59,467,42,492
Carmarthenshire 023,W02000164,6948,6282,666,96,538,32,507
Carmarthenshire 024,W02000165,6761,6122,639,70,510,59,521
Carmarthenshire 025,W02000166,8713,7844,869,195,644,30,535
Carmarthenshire 026,W02000167,9747,8244,1503,475,915,113,1011
Carmarthenshire 027,W02000418,12211,11012,1199,421,750,28,622
Swansea 001,W02000168,6281,5654,627,118,484,25,297
Swansea 002,W02000169,9353,8627,726,205,495,26,487
Swansea 003,W02000170,9111,8504,607,116,453,38,614
Swansea 004,W02000171,7907,7326,581,124,429,28,502
Swansea 005,W02000172,9824,9007,817,198,602,17,564
Swansea 006,W02000173,7392,6767,625,114,491,20,499
Swansea 007,W02000174,9134,8628,506,80,414,12,478
Swansea 008,W02000175,7817,7077,740,132,563,45,687
Swansea 009,W02000176,8872,8258,614,85,503,26,515
Swansea 010,W02000177,7041,6432,609,84,498,27,482
Swansea 011,W02000178,8866,7863,1003,228,725,50,690
Swansea 012,W02000179,6778,6269,509,123,368,18,528
Swansea 013,W02000180,8086,7422,664,73,565,26,476
Swansea 014,W02000181,6857,6211,646,125,491,30,404
Swansea 015,W02000182,7972,7200,772,148,591,33,654
Swansea 016,W02000183,9241,8139,1102,225,834,43,938
Swansea 017,W02000184,6963,6392,571,83,448,40,522
Swansea 018,W02000185,5218,4850,368,84,273,11,276
Swansea 019,W02000186,8696,7719,977,281,631,65,747
Swansea 020,W02000187,5714,5347,367,69,271,27,367
Swansea 021,W02000188,7187,6164,1023,206,758,59,568
Swansea 022,W02000189,7955,7270,685,90,566,29,640
Swansea 023,W02000190,5702,4243,1459,37,1326,96,1318
Swansea 024,W02000191,9962,6849,3113,406,2412,295,2009
Swansea 025,W02000192,9006,6019,2987,437,2242,308,1851
Swansea 026,W02000193,9507,5404,4103,850,2936,317,1978
Swansea 027,W02000194,6346,4918,1428,68,1222,138,1408
Swansea 028,W02000195,5927,5429,498,78,378,42,317
Swansea 029,W02000196,6448,5852,596,87,470,39,499
Swansea 030,W02000197,6384,5931,453,108,317,28,347
Swansea 031,W02000198,7476,6605,871,220,591,60,618
Neath Port Talbot 002,W02000200,5227,4893,334,131,196,7,223
Neath Port Talbot 003,W02000201,5419,5081,338,165,159,14,200
Neath Port Talbot 004,W02000202,11601,10746,855,330,498,27,607
Neath Port Talbot 005,W02000203,6774,6250,524,166,344,14,339
Neath Port Talbot 006,W02000204,6952,6496,456,82,363,11,383
Neath Port Talbot 007,W02000205,5961,5614,347,54,280,13,341
Neath Port Talbot 008,W02000206,6785,6093,692,144,542,6,528
Neath Port Talbot 009,W02000207,5200,4932,268,45,206,17,269
Neath Port Talbot 010,W02000208,9053,8242,811,226,561,24,526
Neath Port Talbot 011,W02000209,5283,4853,430,230,193,7,323
Neath Port Talbot 012,W02000210,6493,6004,489,113,363,13,420
Neath Port Talbot 013,W02000211,7951,7251,700,221,467,12,532
Neath Port Talbot 014,W02000212,7690,7098,592,205,378,9,305
Neath Port Talbot 015,W02000213,6819,6373,446,96,338,12,335
Neath Port Talbot 016,W02000214,9808,9029,779,191,575,13,520
Neath Port Talbot 017,W02000215,9264,8164,1100,357,707,36,679
Neath Port Talbot 018,W02000216,7073,6376,697,154,514,29,488
Neath Port Talbot 019,W02000217,6384,5794,590,117,455,18,488
Neath Port Talbot 020,W02000417,10075,9212,863,307,531,25,559
Bridgend 001,W02000218,6995,6406,589,288,297,4,345
Bridgend 002,W02000219,7415,6868,547,193,346,8,446
Bridgend 003,W02000220,7954,7251,703,312,375,16,399
Bridgend 004,W02000221,7784,7149,635,330,293,12,364
Bridgend 005,W02000222,6202,5779,423,119,292,12,322
Bridgend 006,W02000223,5406,4940,466,90,362,14,300
Bridgend 007,W02000224,6014,5562,452,64,380,8,333
Bridgend 008,W02000225,8886,8241,645,181,432,32,455
Bridgend 009,W02000226,10054,9326,728,229,471,28,549
Bridgend 010,W02000227,7059,6339,720,248,458,14,430
Bridgend 011,W02000228,6961,5785,1176,51,1074,51,669
Bridgend 012,W02000229,6135,5641,494,93,380,21,409
Bridgend 013,W02000230,5453,5052,401,30,336,35,390
Bridgend 014,W02000231,8169,7258,911,176,658,77,693
Bridgend 015,W02000232,6005,5462,543,99,416,28,449
Bridgend 016,W02000233,6226,5605,621,80,512,29,576
Bridgend 017,W02000234,10455,9346,1109,207,850,52,631
Bridgend 018,W02000235,9009,8185,824,249,546,29,524
Bridgend 019,W02000236,6996,6391,605,123,455,27,390
The Vale of Glamorgan 001,W02000237,5281,4911,370,51,298,21,322
The Vale of Glamorgan 002,W02000238,6180,5692,488,91,352,45,399
The Vale of Glamorgan 003,W02000239,6679,6151,528,66,424,38,434
The Vale of Glamorgan 004,W02000240,8714,8051,663,104,513,46,596
The Vale of Glamorgan 005,W02000241,9858,8383,1475,344,1048,83,993
The Vale of Glamorgan 006,W02000242,7799,7277,522,144,352,26,453
The Vale of Glamorgan 007,W02000243,9153,8305,848,198,633,17,735
The Vale of Glamorgan 008,W02000244,10031,9109,922,180,677,65,754
The Vale of Glamorgan 009,W02000245,8543,7747,796,116,664,16,716
The Vale of Glamorgan 010,W02000246,5477,5126,351,78,253,20,375
The Vale of Glamorgan 011,W02000247,8936,8043,893,241,467,185,542
The Vale of Glamorgan 012,W02000248,10843,9351,1492,334,1107,51,972
The Vale of Glamorgan 013,W02000249,9010,8072,938,164,748,26,740
The Vale of Glamorgan 014,W02000250,11356,9999,1357,327,967,63,1132
The Vale of Glamorgan 015,W02000251,8476,7544,932,116,786,30,729
Cardiff 001,W02000367,6068,5603,465,37,401,27,425
Cardiff 002,W02000368,5946,5409,537,83,436,18,506
Cardiff 003,W02000369,7968,7032,936,131,710,95,817
Cardiff 004,W02000370,6509,6050,459,45,389,25,336
Cardiff 005,W02000371,9110,8028,1082,84,960,38,723
Cardiff 006,W02000372,7613,6912,701,130,535,36,437
Cardiff 007,W02000373,6541,5972,569,79,443,47,501
Cardiff 008,W02000374,5683,5256,427,38,355,34,396
Cardiff 009,W02000375,7062,6210,852,91,693,68,651
Cardiff 010,W02000376,6780,6178,602,74,491,37,612
Cardiff 011,W02000377,7125,6430,695,90,567,38,598
Cardiff 012,W02000378,7384,6641,743,58,620,65,587
Cardiff 013,W02000379,6270,5580,690,128,538,24,603
Cardiff 014,W02000380,7108,6604,504,102,387,15,532
Cardiff 015,W02000381,6271,5749,522,68,420,34,456
Cardiff 016,W02000382,5738,5232,506,109,386,11,447
Cardiff 017,W02000383,7219,6654,565,104,418,43,437
Cardiff 018,W02000384,5753,5147,606,52,499,55,549
Cardiff 019,W02000385,6818,5644,1174,67,976,131,800
Cardiff 020,W02000386,7748,7138,610,56,520,34,595
Cardiff 021,W02000387,5962,5246,716,32,640,44,660
Cardiff 022,W02000388,5888,5430,458,51,391,16,432
Cardiff 023,W02000389,8344,7610,734,123,591,20,588
Cardiff 024,W02000390,6335,5159,1176,31,1051,94,971
Cardiff 025,W02000391,8790,4391,4399,322,3587,490,2944
Cardiff 026,W02000392,8997,7737,1260,128,1019,113,1064
Cardiff 027,W02000393,6342,5666,676,83,566,27,541
Cardiff 028,W02000394,8922,3787,5135,746,3980,409,3147
Cardiff 029,W02000395,6322,5153,1169,67,977,125,858
Cardiff 030,W02000396,8079,4780,3299,341,2613,345,2286
Cardiff 031,W02000397,6639,6056,583,81,458,44,490
Cardiff 032,W02000398,11199,3467,7732,1571,5098,1063,4159
Cardiff 033,W02000399,10087,5693,4394,506,3383,505,2898
Cardiff 034,W02000400,6531,5075,1456,213,1124,119,1043
Cardiff 035,W02000401,5947,5237,710,76,582,52,601
Cardiff 036,W02000402,10371,6746,3625,305,2900,420,2314
Cardiff 037,W02000403,7213,6275,938,130,762,46,748
Cardiff 038,W02000404,6048,5191,857,87,709,61,824
Cardiff 039,W02000405,7507,6802,705,181,502,22,572
Cardiff 040,W02000406,8357,7021,1336,133,1123,80,938
Cardiff 041,W02000407,6406,5796,610,85,512,13,545
Cardiff 042,W02000408,7240,5710,1530,248,952,330,1041
Cardiff 043,W02000409,5886,5461,425,87,327,11,336
Cardiff 044,W02000410,8423,6818,1605,176,1216,213,1115
Cardiff 045,W02000411,6454,5857,597,100,478,19,435
Cardiff 046,W02000412,6816,5884,932,125,700,107,669
Cardiff 048,W02000422,6043,3895,2148,147,1820,181,1461
Cardiff 049,W02000423,8228,6133,2095,185,1676,234,1361
Rhondda Cynon Taf 001,W02000252,8947,8161,786,367,370,49,463
Rhondda Cynon Taf 002,W02000253,6279,5679,600,175,414,11,398
Rhondda Cynon Taf 003,W02000254,7728,7091,637,135,466,36,540
Rhondda Cynon Taf 004,W02000255,6202,5643,559,152,394,13,346
Rhondda Cynon Taf 005,W02000256,9865,8887,978,404,545,29,496
Rhondda Cynon Taf 006,W02000257,7374,6815,559,208,308,43,334
Rhondda Cynon Taf 007,W02000258,5727,5285,442,230,209,3,212
Rhondda Cynon Taf 008,W02000259,5789,5378,411,154,239,18,292
Rhondda Cynon Taf 009,W02000260,5878,5449,429,196,226,7,260
Rhondda Cynon Taf 010,W02000261,7694,7102,592,229,348,15,412
Rhondda Cynon Taf 011,W02000262,5232,4810,422,129,289,4,312
Rhondda Cynon Taf 012,W02000263,6390,5793,597,238,347,12,260
Rhondda Cynon Taf 013,W02000264,6006,5379,627,223,368,36,339
Rhondda Cynon Taf 014,W02000265,9192,8452,740,230,470,40,488
Rhondda Cynon Taf 015,W02000266,7523,6969,554,247,295,12,447
Rhondda Cynon Taf 016,W02000267,6549,5909,640,177,414,49,419
Rhondda Cynon Taf 017,W02000268,9156,8370,786,221,532,33,456
Rhondda Cynon Taf 018,W02000269,8503,7690,813,241,539,33,416
Rhondda Cynon Taf 019,W02000270,6609,5997,612,146,441,25,442
Rhondda Cynon Taf 020,W02000271,5639,5147,492,143,321,28,344
Rhondda Cynon Taf 021,W02000272,9983,9038,945,191,673,81,768
Rhondda Cynon Taf 022,W02000273,9915,6918,2997,989,1507,501,1371
Rhondda Cynon Taf 023,W02000274,9810,8995,815,295,501,19,496
Rhondda Cynon Taf 024,W02000275,5927,5499,428,129,287,12,372
Rhondda Cynon Taf 025,W02000276,5766,5363,403,82,303,18,284
Rhondda Cynon Taf 026,W02000277,7000,6420,580,69,493,18,438
Rhondda Cynon Taf 027,W02000278,9402,8715,687,165,510,12,535
Rhondda Cynon Taf 028,W02000279,7703,7175,528,153,357,18,469
Rhondda Cynon Taf 029,W02000280,8012,7327,685,148,491,46,589
Rhondda Cynon Taf 030,W02000281,7610,6891,719,157,523,39,496
Rhondda Cynon Taf 031,W02000282,11000,9979,1021,293,677,51,677
Merthyr Tydfil 002,W02000284,9748,8815,933,329,548,56,610
Merthyr Tydfil 003,W02000285,8363,7641,722,146,505,71,546
Merthyr Tydfil 004,W02000286,6574,5869,705,171,475,59,446
Merthyr Tydfil 005,W02000287,8141,7498,643,152,454,37,461
Merthyr Tydfil 006,W02000288,8340,7751,589,233,349,7,382
Merthyr Tydfil 007,W02000289,8241,7627,614,256,334,24,382
Merthyr Tydfil 008,W02000415,9395,8740,655,219,406,30,438
Caerphilly 001,W02000290,8845,8150,695,355,331,9,370
Caerphilly 002,W02000291,7573,6961,612,259,346,7,400
Caerphilly 003,W02000292,5704,5206,498,103,387,8,306
Caerphilly 004,W02000293,6196,5713,483,177,297,9,373
Caerphilly 005,W02000294,5715,5308,407,90,307,10,363
Caerphilly 006,W02000295,9429,8768,661,237,400,24,429
Caerphilly 007,W02000296,7742,7123,619,151,459,9,489
Caerphilly 008,W02000297,7817,7255,562,159,376,27,504
Caerphilly 009,W02000298,7319,6782,537,80,447,10,444
Caerphilly 010,W02000299,6509,5994,515,118,389,8,340
Caerphilly 011,W02000300,8552,7921,631,150,475,6,485
Caerphilly 012,W02000301,7790,7200,590,125,450,15,451
Caerphilly 013,W02000302,9690,8680,1010,239,750,21,491
Caerphilly 014,W02000303,6998,6394,604,131,459,14,473
Caerphilly 015,W02000304,5567,5061,506,101,392,13,327
Caerphilly 016,W02000305,6464,6040,424,82,332,10,325
Caerphilly 017,W02000306,5229,4793,436,107,321,8,317
Caerphilly 018,W02000307,6799,6163,636,258,366,12,373
Caerphilly 019,W02000308,9292,8582,710,196,502,12,637
Caerphilly 020,W02000309,6859,6419,440,145,283,12,391
Caerphilly 021,W02000310,5455,5069,386,72,300,14,363
Caerphilly 022,W02000311,9505,8669,836,232,585,19,736
Caerphilly 023,W02000312,7500,6939,561,95,450,16,505
Caerphilly 024,W02000313,10257,9298,959,144,783,32,674
Blaenau Gwent 001,W02000314,7100,6527,573,197,360,16,365
Blaenau Gwent 002,W02000315,5530,5002,528,203,318,7,309
Blaenau Gwent 003,W02000316,7125,6684,441,112,305,24,309
Blaenau Gwent 004,W02000317,7671,7066,605,184,402,19,419
Blaenau Gwent 005,W02000318,9443,8764,679,293,372,14,436
Blaenau Gwent 006,W02000319,7978,7320,658,287,353,18,437
Blaenau Gwent 007,W02000320,8569,7790,779,272,490,17,473
Blaenau Gwent 008,W02000321,9119,8295,824,418,374,32,414
Blaenau Gwent 009,W02000322,7279,6765,514,181,300,33,385
Torfaen 001,W02000323,6055,5511,544,255,283,6,241
Torfaen 002,W02000324,7064,6419,645,208,429,8,458
Torfaen 003,W02000325,7210,6594,616,167,438,11,490
Torfaen 004,W02000326,9008,8254,754,205,537,12,571
Torfaen 005,W02000327,5986,5602,384,61,309,14,356
Torfaen 006,W02000328,7217,6612,605,148,436,21,430
Torfaen 007,W02000329,7505,6899,606,99,497,10,478
Torfaen 008,W02000330,7259,6668,591,149,434,8,470
Torfaen 009,W02000331,6767,6258,509,119,385,5,486
Torfaen 010,W02000332,6822,6213,609,101,492,16,458
Torfaen 011,W02000333,6558,6077,481,81,378,22,469
Torfaen 012,W02000334,6791,6386,405,67,317,21,453
Torfaen 013,W02000335,6833,6218,615,81,513,21,396
Monmouthshire 001,W02000336,8148,7299,849,178,629,42,680
Monmouthshire 002,W02000337,7506,6860,646,168,434,44,530
Monmouthshire 003,W02000338,7665,6901,764,134,605,25,446
Monmouthshire 004,W02000339,10508,9246,1262,474,662,126,680
Monmouthshire 005,W02000340,7220,6597,623,97,485,41,469
Monmouthshire 006,W02000341,8387,7523,864,207,618,39,521
Monmouthshire 007,W02000342,9673,8831,842,117,655,70,646
Monmouthshire 008,W02000343,8534,7557,977,357,578,42,580
Monmouthshire 009,W02000344,7565,6933,632,104,496,32,518
Monmouthshire 010,W02000345,8164,7518,646,239,362,45,440
Monmouthshire 011,W02000346,7953,7353,600,194,376,30,454
Newport 001,W02000347,8061,7359,702,198,486,18,893
Newport 002,W02000348,7997,7433,564,124,416,24,491
Newport 003,W02000349,7606,6918,688,219,436,33,576
Newport 004,W02000350,7386,6904,482,100,367,15,491
Newport 005,W02000351,6072,5574,498,62,409,27,357
Newport 006,W02000352,6598,5887,711,92,582,37,596
Newport 007,W02000353,7066,6262,804,112,638,54,728
Newport 008,W02000354,5982,5607,375,36,332,7,434
Newport 009,W02000355,8434,7924,510,81,401,28,533
Newport 010,W02000356,5389,5016,373,92,264,17,313
Newport 011,W02000357,7899,6933,966,116,746,104,779
Newport 012,W02000358,5951,5427,524,49,447,28,496
Newport 013,W02000359,9855,8150,1705,288,1267,150,953
Newport 014,W02000360,6141,4934,1207,144,908,155,823
Newport 015,W02000361,10686,9496,1190,136,954,100,628
Newport 016,W02000362,5986,5545,441,64,348,29,320
Newport 017,W02000363,5657,5274,383,42,330,11,354
Newport 018,W02000364,7318,5880,1438,284,1089,65,737
Newport 019,W02000365,7485,6809,676,105,550,21,572
Newport 020,W02000366,8167,7397,770,85,647,38,679
